┇	BOX DRAWINGS HEAVY TRIPLE DASH VERTICAL
┥	BOX DRAWINGS VERTICAL LIGHT AND LEFT HEAVY = Videotex Mosaic DG 04
┝	BOX DRAWINGS VERTICAL LIGHT AND RIGHT HEAVY = Videotex Mosaic DG 03
┈	BOX DRAWINGS LIGHT QUADRUPLE DASH HORIZONTAL
⎬	RIGHT CURLY BRACKET MIDDLE PIECE
﴾	ORNATE LEFT PARENTHESIS
)	RIGHT PARENTHESIS = closing parenthesis
⚡	HIGH VOLTAGE SIGN = thunder = lightning symbol
⚫	MEDIUM BLACK CIRCLE
➲	CIRCLED HEAVY WHITE RIGHTWARDS ARROW
⟹	LONG RIGHTWARDS DOUBLE ARROW
☛	BLACK RIGHT POINTING INDEX
▶	BLACK RIGHT-POINTING TRIANGLE
►	BLACK RIGHT-POINTING POINTER
☞	WHITE RIGHT POINTING INDEX = fist (typographic term)
≥	GREATER-THAN OR EQUAL TO
›	SINGLE RIGHT-POINTING ANGLE QUOTATION MARK = right pointing single guillemet
┫	BOX DRAWINGS HEAVY VERTICAL AND LEFT
ℂ	DOUBLE-STRUCK CAPITAL C = the set of complex numbers
─	BOX DRAWINGS LIGHT HORIZONTAL = Videotex Mosaic DG 15
▎	LEFT ONE QUARTER BLOCK
⎜	LEFT PARENTHESIS EXTENSION
◉	FISHEYE = tainome (Japanese, a kind of bullet)
‧	HYPHENATION POINT
╼	BOX DRAWINGS LIGHT LEFT AND HEAVY RIGHT
╍	BOX DRAWINGS HEAVY DOUBLE DASH HORIZONTAL
╰	BOX DRAWINGS LIGHT ARC UP AND RIGHT
╭	BOX DRAWINGS LIGHT ARC DOWN AND RIGHT
➤	BLACK RIGHTWARDS ARROWHEAD
&	AMPERSAND
█	FULL BLOCK = solid
⤷	ARROW POINTING DOWNWARDS THEN CURVING RIGHTWARDS
…	HORIZONTAL ELLIPSIS = three dot leader
➙	HEAVY RIGHTWARDS ARROW
⟶	LONG RIGHTWARDS ARROW
⌁	ELECTRIC ARROW
!	EXCLAMATION MARK = factorial = bang
"	QUOTATION MARK
#	NUMBER SIGN = pound sign, hash, crosshatch, octothorpe
$	DOLLAR SIGN = milreis, escudo
%	PERCENT SIGN
'	APOSTROPHE = apostrophe-quote = APL quote
(	LEFT PARENTHESIS = opening parenthesis
*	ASTERISK = star (on phone keypads)
+	PLUS SIGN
,	COMMA = decimal separator
-	HYPHEN-MINUS = hyphen or minus sign
.	FULL STOP (period, dot, decimal point)
/	SOLIDUS (slash, virgule)
0	DIGIT ZERO
1	DIGIT ONE
2	DIGIT TWO
3	DIGIT THREE
4	DIGIT FOUR
5	DIGIT FIVE
6	DIGIT SIX
7	DIGIT SEVEN
8	DIGIT EIGHT
9	DIGIT NINE
:	COLON
;	SEMICOLON
<	LESS-THAN SIGN
=	EQUALS SIGN
>	GREATER-THAN SIGN
?	QUESTION MARK
@	COMMERCIAL AT (at sign)
A	LATIN CAPITAL LETTER A
B	LATIN CAPITAL LETTER B
C	LATIN CAPITAL LETTER C
D	LATIN CAPITAL LETTER D
E	LATIN CAPITAL LETTER E
F	LATIN CAPITAL LETTER F
G	LATIN CAPITAL LETTER G
H	LATIN CAPITAL LETTER H
I	LATIN CAPITAL LETTER I
J	LATIN CAPITAL LETTER J
K	LATIN CAPITAL LETTER K
L	LATIN CAPITAL LETTER L
M	LATIN CAPITAL LETTER M
N	LATIN CAPITAL LETTER N
O	LATIN CAPITAL LETTER O
P	LATIN CAPITAL LETTER P
Q	LATIN CAPITAL LETTER Q
R	LATIN CAPITAL LETTER R
S	LATIN CAPITAL LETTER S
T	LATIN CAPITAL LETTER T
U	LATIN CAPITAL LETTER U
V	LATIN CAPITAL LETTER V
W	LATIN CAPITAL LETTER W
X	LATIN CAPITAL LETTER X
Y	LATIN CAPITAL LETTER Y
Z	LATIN CAPITAL LETTER Z
[	LEFT SQUARE BRACKET = opening square bracket
\	REVERSE SOLIDUS = backslash
]	RIGHT SQUARE BRACKET = closing square bracket
^	CIRCUMFLEX ACCENT
_	LOW LINE (spacing underscore)
`	GRAVE ACCENT
a	LATIN SMALL LETTER A
b	LATIN SMALL LETTER B
c	LATIN SMALL LETTER C
d	LATIN SMALL LETTER D
e	LATIN SMALL LETTER E
f	LATIN SMALL LETTER F
g	LATIN SMALL LETTER G
h	LATIN SMALL LETTER H
i	LATIN SMALL LETTER I
j	LATIN SMALL LETTER J
k	LATIN SMALL LETTER K
l	LATIN SMALL LETTER L
m	LATIN SMALL LETTER M
n	LATIN SMALL LETTER N
o	LATIN SMALL LETTER O
p	LATIN SMALL LETTER P
q	LATIN SMALL LETTER Q
r	LATIN SMALL LETTER R
s	LATIN SMALL LETTER S
t	LATIN SMALL LETTER T
u	LATIN SMALL LETTER U
v	LATIN SMALL LETTER V
w	LATIN SMALL LETTER W
x	LATIN SMALL LETTER X
y	LATIN SMALL LETTER Y
z	LATIN SMALL LETTER Z
{	LEFT CURLY BRACKET = opening curly bracket = left brace
|	VERTICAL LINE = vertical bar
}	RIGHT CURLY BRACKET = closing curly bracket = right brace
~	TILDE
	<control> = DELETE
   NO-BREAK SPACE (commonly abbreviated as NBSP)
¡	INVERTED EXCLAMATION MARK (Spanish, Asturian, Galician)
¢	CENT SIGN
£	POUND SIGN (pound sterling, Irish punt, Italian lira, Turkish lira, etc.)
¤	CURRENCY SIGN
¥	YEN SIGN = yuan sign
¦	BROKEN BAR = broken vertical bar = parted rule (in typography)
§	SECTION SIGN
¨	DIAERESIS
©	COPYRIGHT SIGN
ª	FEMININE ORDINAL INDICATOR (windows "alt 166")
«	LEFT-POINTING DOUBLE ANGLE QUOTATION MARK = left guillemet = chevrons (in typography)
¬	NOT SIGN = angled dash (in typography)
 SOFT HYPHEN = discretionary hyphen
®	REGISTERED SIGN = registered trade mark sign
¯	MACRON = overline, APL overbar
°	DEGREE SIGN
±	PLUS-MINUS SIGN
²	SUPERSCRIPT TWO = squared
³	SUPERSCRIPT THREE = cubed
´	ACUTE ACCENT
µ	MICRO SIGN
¶	PILCROW SIGN = paragraph sign
·	MIDDLE DOT = midpoint (in typography) = Georgian comma = Greek middle dot (ano teleia)
¸	CEDILLA
¹	SUPERSCRIPT ONE
º	MASCULINE ORDINAL INDICATOR (windows "alt 167")
»	RIGHT-POINTING DOUBLE ANGLE QUOTATION MARK = right guillemet
¼	VULGAR FRACTION ONE QUARTER
½	VULGAR FRACTION ONE HALF
¾	VULGAR FRACTION THREE QUARTERS
¿	INVERTED QUESTION MARK = turned question mark
À	LATIN CAPITAL LETTER A WITH GRAVE
Á	LATIN CAPITAL LETTER A WITH ACUTE
Â	LATIN CAPITAL LETTER A WITH CIRCUMFLEX
Ã	LATIN CAPITAL LETTER A WITH TILDE
Ä	LATIN CAPITAL LETTER A WITH DIAERESIS
Å	LATIN CAPITAL LETTER A WITH RING ABOVE
Æ	LATIN CAPITAL LETTER AE = latin capital ligature ae
Ç	LATIN CAPITAL LETTER C WITH CEDILLA
È	LATIN CAPITAL LETTER E WITH GRAVE
É	LATIN CAPITAL LETTER E WITH ACUTE
Ê	LATIN CAPITAL LETTER E WITH CIRCUMFLEX
Ë	LATIN CAPITAL LETTER E WITH DIAERESIS
Ì	LATIN CAPITAL LETTER I WITH GRAVE
Í	LATIN CAPITAL LETTER I WITH ACUTE
Î	LATIN CAPITAL LETTER I WITH CIRCUMFLEX
Ï	LATIN CAPITAL LETTER I WITH DIAERESIS
Ð	LATIN CAPITAL LETTER ETH
Ñ	LATIN CAPITAL LETTER N WITH TILDE
Ò	LATIN CAPITAL LETTER O WITH GRAVE
Ó	LATIN CAPITAL LETTER O WITH ACUTE
Ô	LATIN CAPITAL LETTER O WITH CIRCUMFLEX
Õ	LATIN CAPITAL LETTER O WITH TILDE
Ö	LATIN CAPITAL LETTER O WITH DIAERESIS
×	MULTIPLICATION SIGN = z notation Cartesian product
Ø	LATIN CAPITAL LETTER O WITH STROKE = o slash
Ù	LATIN CAPITAL LETTER U WITH GRAVE
Ú	LATIN CAPITAL LETTER U WITH ACUTE
Û	LATIN CAPITAL LETTER U WITH CIRCUMFLEX
Ü	LATIN CAPITAL LETTER U WITH DIAERESIS
Ý	LATIN CAPITAL LETTER Y WITH ACUTE
Þ	LATIN CAPITAL LETTER THORN
ß	LATIN SMALL LETTER SHARP S = Eszett
à	LATIN SMALL LETTER A WITH GRAVE
á	LATIN SMALL LETTER A WITH ACUTE
â	LATIN SMALL LETTER A WITH CIRCUMFLEX
ã	LATIN SMALL LETTER A WITH TILDE
ä	LATIN SMALL LETTER A WITH DIAERESIS
å	LATIN SMALL LETTER A WITH RING ABOVE
æ	LATIN SMALL LETTER AE = latin small ligature ae = ash (from Old English æsc)
ç	LATIN SMALL LETTER C WITH CEDILLA
è	LATIN SMALL LETTER E WITH GRAVE
é	LATIN SMALL LETTER E WITH ACUTE
ê	LATIN SMALL LETTER E WITH CIRCUMFLEX
ë	LATIN SMALL LETTER E WITH DIAERESIS
ì	LATIN SMALL LETTER I WITH GRAVE
í	LATIN SMALL LETTER I WITH ACUTE
î	LATIN SMALL LETTER I WITH CIRCUMFLEX
ï	LATIN SMALL LETTER I WITH DIAERESIS
ð	LATIN SMALL LETTER ETH
ñ	LATIN SMALL LETTER N WITH TILDE
ò	LATIN SMALL LETTER O WITH GRAVE
ó	LATIN SMALL LETTER O WITH ACUTE
ô	LATIN SMALL LETTER O WITH CIRCUMFLEX
õ	LATIN SMALL LETTER O WITH TILDE
ö	LATIN SMALL LETTER O WITH DIAERESIS
÷	DIVISION SIGN
ø	LATIN SMALL LETTER O WITH STROKE = o slash
ù	LATIN SMALL LETTER U WITH GRAVE
ú	LATIN SMALL LETTER U WITH ACUTE
û	LATIN SMALL LETTER U WITH CIRCUMFLEX
ü	LATIN SMALL LETTER U WITH DIAERESIS
ý	LATIN SMALL LETTER Y WITH ACUTE
þ	LATIN SMALL LETTER THORN
ÿ	LATIN SMALL LETTER Y WITH DIAERESIS
Ł	LATIN CAPITAL LETTER L WITH STROKE
ł	LATIN SMALL LETTER L WITH STROKE
Ń	LATIN CAPITAL LETTER N WITH ACUTE
ń	LATIN SMALL LETTER N WITH ACUTE
Ņ	LATIN CAPITAL LETTER N WITH CEDILLA
ņ	LATIN SMALL LETTER N WITH CEDILLA
Ň	LATIN CAPITAL LETTER N WITH CARON
ň	LATIN SMALL LETTER N WITH CARON
Ŋ	LATIN CAPITAL LETTER ENG
ŋ	LATIN SMALL LETTER ENG = engma, angma
Ō	LATIN CAPITAL LETTER O WITH MACRON
ō	LATIN SMALL LETTER O WITH MACRON
Ŏ	LATIN CAPITAL LETTER O WITH BREVE
ŏ	LATIN SMALL LETTER O WITH BREVE
Ő	LATIN CAPITAL LETTER O WITH DOUBLE ACUTE
ő	LATIN SMALL LETTER O WITH DOUBLE ACUTE
Œ	LATIN CAPITAL LIGATURE OE
œ	LATIN SMALL LIGATURE OE = ethel (from Old English)
Ŕ	LATIN CAPITAL LETTER R WITH ACUTE
ŕ	LATIN SMALL LETTER R WITH ACUTE
Ŗ	LATIN CAPITAL LETTER R WITH CEDILLA
ŗ	LATIN SMALL LETTER R WITH CEDILLA
Ř	LATIN CAPITAL LETTER R WITH CARON
ř	LATIN SMALL LETTER R WITH CARON
Ś	LATIN CAPITAL LETTER S WITH ACUTE
ś	LATIN SMALL LETTER S WITH ACUTE
Ŝ	LATIN CAPITAL LETTER S WITH CIRCUMFLEX
ŝ	LATIN SMALL LETTER S WITH CIRCUMFLEX
Ş	LATIN CAPITAL LETTER S WITH CEDILLA
ş	LATIN SMALL LETTER S WITH CEDILLA
Š	LATIN CAPITAL LETTER S WITH CARON
š	LATIN SMALL LETTER S WITH CARON
Ţ	LATIN CAPITAL LETTER T WITH CEDILLA
ţ	LATIN SMALL LETTER T WITH CEDILLA
Ť	LATIN CAPITAL LETTER T WITH CARON
ť	LATIN SMALL LETTER T WITH CARON
Ŧ	LATIN CAPITAL LETTER T WITH STROKE
ŧ	LATIN SMALL LETTER T WITH STROKE
Ũ	LATIN CAPITAL LETTER U WITH TILDE
ũ	LATIN SMALL LETTER U WITH TILDE
Ū	LATIN CAPITAL LETTER U WITH MACRON
ū	LATIN SMALL LETTER U WITH MACRON
Ŭ	LATIN CAPITAL LETTER U WITH BREVE
ŭ	LATIN SMALL LETTER U WITH BREVE
Ů	LATIN CAPITAL LETTER U WITH RING ABOVE
ů	LATIN SMALL LETTER U WITH RING ABOVE
Ű	LATIN CAPITAL LETTER U WITH DOUBLE ACUTE
ű	LATIN SMALL LETTER U WITH DOUBLE ACUTE
Ŵ	LATIN CAPITAL LETTER W WITH CIRCUMFLEX
ŵ	LATIN SMALL LETTER W WITH CIRCUMFLEX
Ŷ	LATIN CAPITAL LETTER Y WITH CIRCUMFLEX
ŷ	LATIN SMALL LETTER Y WITH CIRCUMFLEX
Ÿ	LATIN CAPITAL LETTER Y WITH DIAERESIS
Ź	LATIN CAPITAL LETTER Z WITH ACUTE
ź	LATIN SMALL LETTER Z WITH ACUTE
Ż	LATIN CAPITAL LETTER Z WITH DOT ABOVE
ż	LATIN SMALL LETTER Z WITH DOT ABOVE
Ž	LATIN CAPITAL LETTER Z WITH CARON
ž	LATIN SMALL LETTER Z WITH CARON
ſ	LATIN SMALL LETTER LONG S
Ɔ	LATIN CAPITAL LETTER OPEN O
Ǝ	LATIN CAPITAL LETTER REVERSED E = turned e
Ɯ	LATIN CAPITAL LETTER TURNED M
ɐ	LATIN SMALL LETTER TURNED A
ɑ	LATIN SMALL LETTER ALPHA = latin small letter script a
ɒ	LATIN SMALL LETTER TURNED ALPHA
ɔ	LATIN SMALL LETTER OPEN O
ɘ	LATIN SMALL LETTER REVERSED E
ə	LATIN SMALL LETTER SCHWA
ɛ	LATIN SMALL LETTER OPEN E = epsilon
ɜ	LATIN SMALL LETTER REVERSED OPEN E
ɞ	LATIN SMALL LETTER CLOSED REVERSED OPEN E = closed reversed epsilon
ɟ	LATIN SMALL LETTER DOTLESS J WITH STROKE
ɡ	LATIN SMALL LETTER SCRIPT G
ɢ	LATIN LETTER SMALL CAPITAL G
ɣ	LATIN SMALL LETTER GAMMA
ɤ	LATIN SMALL LETTER RAMS HORN = latin small letter baby gamma
ɥ	LATIN SMALL LETTER TURNED H
ɨ	LATIN SMALL LETTER I WITH STROKE = barred i, i bar
ɪ	LATIN LETTER SMALL CAPITAL I
ɬ	LATIN SMALL LETTER L WITH BELT
ɮ	LATIN SMALL LETTER LEZH
ɯ	LATIN SMALL LETTER TURNED M
ɰ	LATIN SMALL LETTER TURNED M WITH LONG LEG
ɴ	LATIN LETTER SMALL CAPITAL N
ɵ	LATIN SMALL LETTER BARRED O = o bar
ɶ	LATIN LETTER SMALL CAPITAL OE
ɷ	LATIN SMALL LETTER CLOSED OMEGA
ɸ	LATIN SMALL LETTER PHI
ɹ	LATIN SMALL LETTER TURNED R
ʁ	LATIN LETTER SMALL CAPITAL INVERTED R
ʇ	LATIN SMALL LETTER TURNED T
ʌ	LATIN SMALL LETTER TURNED V = caret, wedge
ʍ	LATIN SMALL LETTER TURNED W
ʎ	LATIN SMALL LETTER TURNED Y
ʞ	LATIN SMALL LETTER TURNED K
Α	GREEK CAPITAL LETTER ALPHA
Β	GREEK CAPITAL LETTER BETA
Γ	GREEK CAPITAL LETTER GAMMA = gamma function
Δ	GREEK CAPITAL LETTER DELTA
Ε	GREEK CAPITAL LETTER EPSILON
Ζ	GREEK CAPITAL LETTER ZETA
Η	GREEK CAPITAL LETTER ETA
Θ	GREEK CAPITAL LETTER THETA
Ι	GREEK CAPITAL LETTER IOTA = iota adscript
Κ	GREEK CAPITAL LETTER KAPPA
Λ	GREEK CAPITAL LETTER LAMDA
Μ	GREEK CAPITAL LETTER MU
Ν	GREEK CAPITAL LETTER NU
Ξ	GREEK CAPITAL LETTER XI
Ο	GREEK CAPITAL LETTER OMICRON
Π	GREEK CAPITAL LETTER PI
Ρ	GREEK CAPITAL LETTER RHO
Σ	GREEK CAPITAL LETTER SIGMA
Τ	GREEK CAPITAL LETTER TAU
Υ	GREEK CAPITAL LETTER UPSILON
Φ	GREEK CAPITAL LETTER PHI
Χ	GREEK CAPITAL LETTER CHI
Ψ	GREEK CAPITAL LETTER PSI
Ω	GREEK CAPITAL LETTER OMEGA
α	GREEK SMALL LETTER ALPHA
β	GREEK SMALL LETTER BETA
γ	GREEK SMALL LETTER GAMMA
δ	GREEK SMALL LETTER DELTA
ε	GREEK SMALL LETTER EPSILON
ζ	GREEK SMALL LETTER ZETA
η	GREEK SMALL LETTER ETA
θ	GREEK SMALL LETTER THETA
ι	GREEK SMALL LETTER IOTA
κ	GREEK SMALL LETTER KAPPA
λ	GREEK SMALL LETTER LAMDA = lambda
μ	GREEK SMALL LETTER MU
ν	GREEK SMALL LETTER NU
ξ	GREEK SMALL LETTER XI
ο	GREEK SMALL LETTER OMICRON
π	GREEK SMALL LETTER PI
ρ	GREEK SMALL LETTER RHO
ς	GREEK SMALL LETTER FINAL SIGMA = stigma (the Modern Greek name for this letterform)
σ	GREEK SMALL LETTER SIGMA
τ	GREEK SMALL LETTER TAU
υ	GREEK SMALL LETTER UPSILON
φ	GREEK SMALL LETTER PHI
χ	GREEK SMALL LETTER CHI
ψ	GREEK SMALL LETTER PSI
ω	GREEK SMALL LETTER OMEGA
А	CYRILLIC CAPITAL LETTER A
Б	CYRILLIC CAPITAL LETTER BE
В	CYRILLIC CAPITAL LETTER VE
Г	CYRILLIC CAPITAL LETTER GHE
Д	CYRILLIC CAPITAL LETTER DE
Е	CYRILLIC CAPITAL LETTER IE
Ж	CYRILLIC CAPITAL LETTER ZHE
З	CYRILLIC CAPITAL LETTER ZE
И	CYRILLIC CAPITAL LETTER I
Й	CYRILLIC CAPITAL LETTER SHORT I
К	CYRILLIC CAPITAL LETTER KA
Л	CYRILLIC CAPITAL LETTER EL
М	CYRILLIC CAPITAL LETTER EM
Н	CYRILLIC CAPITAL LETTER EN
О	CYRILLIC CAPITAL LETTER O
П	CYRILLIC CAPITAL LETTER PE
Р	CYRILLIC CAPITAL LETTER ER
С	CYRILLIC CAPITAL LETTER ES
Т	CYRILLIC CAPITAL LETTER TE
У	CYRILLIC CAPITAL LETTER U
Ф	CYRILLIC CAPITAL LETTER EF
Х	CYRILLIC CAPITAL LETTER HA
Ц	CYRILLIC CAPITAL LETTER TSE
Ч	CYRILLIC CAPITAL LETTER CHE
Ш	CYRILLIC CAPITAL LETTER SHA
Щ	CYRILLIC CAPITAL LETTER SHCHA
Ъ	CYRILLIC CAPITAL LETTER HARD SIGN
Ы	CYRILLIC CAPITAL LETTER YERU
Ь	CYRILLIC CAPITAL LETTER SOFT SIGN
Э	CYRILLIC CAPITAL LETTER E
Ю	CYRILLIC CAPITAL LETTER YU
Я	CYRILLIC CAPITAL LETTER YA
а	CYRILLIC SMALL LETTER A
б	CYRILLIC SMALL LETTER BE
в	CYRILLIC SMALL LETTER VE
г	CYRILLIC SMALL LETTER GHE
д	CYRILLIC SMALL LETTER DE
е	CYRILLIC SMALL LETTER IE
ж	CYRILLIC SMALL LETTER ZHE
з	CYRILLIC SMALL LETTER ZE
и	CYRILLIC SMALL LETTER I
й	CYRILLIC SMALL LETTER SHORT I
к	CYRILLIC SMALL LETTER KA
л	CYRILLIC SMALL LETTER EL
м	CYRILLIC SMALL LETTER EM
н	CYRILLIC SMALL LETTER EN
о	CYRILLIC SMALL LETTER O
п	CYRILLIC SMALL LETTER PE
р	CYRILLIC SMALL LETTER ER
с	CYRILLIC SMALL LETTER ES
т	CYRILLIC SMALL LETTER TE
у	CYRILLIC SMALL LETTER U
ф	CYRILLIC SMALL LETTER EF
х	CYRILLIC SMALL LETTER HA
ц	CYRILLIC SMALL LETTER TSE
ч	CYRILLIC SMALL LETTER CHE
ш	CYRILLIC SMALL LETTER SHA
щ	CYRILLIC SMALL LETTER SHCHA
ъ	CYRILLIC SMALL LETTER HARD SIGN
ы	CYRILLIC SMALL LETTER YERU
ь	CYRILLIC SMALL LETTER SOFT SIGN
э	CYRILLIC SMALL LETTER E
ю	CYRILLIC SMALL LETTER YU
я	CYRILLIC SMALL LETTER YA
ᴀ	LATIN LETTER SMALL CAPITAL A
ᴁ	LATIN LETTER SMALL CAPITAL AE
ᴂ	LATIN SMALL LETTER TURNED AE
ᴃ	LATIN LETTER SMALL CAPITAL BARRED B
ᴄ	LATIN LETTER SMALL CAPITAL C
ᴅ	LATIN LETTER SMALL CAPITAL D
ᴆ	LATIN LETTER SMALL CAPITAL ETH
ᴇ	LATIN LETTER SMALL CAPITAL E
ᴈ	LATIN SMALL LETTER TURNED OPEN E
ᴉ	LATIN SMALL LETTER TURNED I
ᴊ	LATIN LETTER SMALL CAPITAL J
ᴋ	LATIN LETTER SMALL CAPITAL K
ᴌ	LATIN LETTER SMALL CAPITAL L WITH STROKE
ᴍ	LATIN LETTER SMALL CAPITAL M
ᴎ	LATIN LETTER SMALL CAPITAL REVERSED N
ᴏ	LATIN LETTER SMALL CAPITAL O
ᴐ	LATIN LETTER SMALL CAPITAL OPEN O
ᴑ	LATIN SMALL LETTER SIDEWAYS O
ᴒ	LATIN SMALL LETTER SIDEWAYS OPEN O
ᴓ	LATIN SMALL LETTER SIDEWAYS O WITH STROKE
ᴔ	LATIN SMALL LETTER TURNED OE
ᴕ	LATIN LETTER SMALL CAPITAL OU
ᴖ	LATIN SMALL LETTER TOP HALF O
ᴗ	LATIN SMALL LETTER BOTTOM HALF O
ᴘ	LATIN LETTER SMALL CAPITAL P
ᴙ	LATIN LETTER SMALL CAPITAL REVERSED R
ᴚ	LATIN LETTER SMALL CAPITAL TURNED R
ᴛ	LATIN LETTER SMALL CAPITAL T
ᴜ	LATIN LETTER SMALL CAPITAL U
ᴝ	LATIN SMALL LETTER SIDEWAYS U
ᴞ	LATIN SMALL LETTER SIDEWAYS DIAERESIZED U
ᴟ	LATIN SMALL LETTER SIDEWAYS TURNED M
ᴠ	LATIN LETTER SMALL CAPITAL V
ᴡ	LATIN LETTER SMALL CAPITAL W
ᴢ	LATIN LETTER SMALL CAPITAL Z
ᴣ	LATIN LETTER SMALL CAPITAL EZH
ᴤ	LATIN LETTER VOICED LARYNGEAL SPIRANT
ᴥ	LATIN LETTER AIN
ᴦ	GREEK LETTER SMALL CAPITAL GAMMA
ᴧ	GREEK LETTER SMALL CAPITAL LAMDA
ᴨ	GREEK LETTER SMALL CAPITAL PI
ᴩ	GREEK LETTER SMALL CAPITAL RHO
ᴪ	GREEK LETTER SMALL CAPITAL PSI
ẞ	LATIN CAPITAL LETTER SHARP S
Ỳ	LATIN CAPITAL LETTER Y WITH GRAVE
ỳ	LATIN SMALL LETTER Y WITH GRAVE
Ỵ	LATIN CAPITAL LETTER Y WITH DOT BELOW
ỵ	LATIN SMALL LETTER Y WITH DOT BELOW
Ỹ	LATIN CAPITAL LETTER Y WITH TILDE
ỹ	LATIN SMALL LETTER Y WITH TILDE
‐	HYPHEN
‑	NON-BREAKING HYPHEN
‒	FIGURE DASH
–	EN DASH
—	EM DASH
―	HORIZONTAL BAR = quotation dash
‖	DOUBLE VERTICAL LINE
‗	DOUBLE LOW LINE
‘	LEFT SINGLE QUOTATION MARK = single turned comma quotation mark
’	RIGHT SINGLE QUOTATION MARK = single comma quotation mark
‚	SINGLE LOW-9 QUOTATION MARK = low single comma quotation mark
‛	SINGLE HIGH-REVERSED-9 QUOTATION MARK = single reversed comma quotation mark
“	LEFT DOUBLE QUOTATION MARK = double turned comma quotation mark
”	RIGHT DOUBLE QUOTATION MARK = double comma quotation mark
„	DOUBLE LOW-9 QUOTATION MARK = low double comma quotation mark
‟	DOUBLE HIGH-REVERSED-9 QUOTATION MARK = double reversed comma quotation mark
†	DAGGER = obelisk, obelus, long cross
‡	DOUBLE DAGGER = diesis, double obelisk
•	BULLET = black small circle
‣	TRIANGULAR BULLET
․	ONE DOT LEADER
‥	TWO DOT LEADER
‰	PER MILLE SIGN = permille, per thousand
‱	PER TEN THOUSAND SIGN = permyriad
′	PRIME = minutes, feet
″	DOUBLE PRIME = seconds, inches
‴	TRIPLE PRIME = lines (old measure, 1/12 of an inch)
‵	REVERSED PRIME
‶	REVERSED DOUBLE PRIME
‷	REVERSED TRIPLE PRIME
‸	CARET
‹	SINGLE LEFT-POINTING ANGLE QUOTATION MARK = left pointing single guillemet
※	REFERENCE MARK = Japanese kome = Urdu paragraph separator
‼	DOUBLE EXCLAMATION MARK
‽	INTERROBANG
‾	OVERLINE = spacing overscore
‿	UNDERTIE = Greek enotikon
⁀	CHARACTER TIE = z notation sequence concatenation
⁁	CARET INSERTION POINT
⁂	ASTERISM
⁃	HYPHEN BULLET
⁄	FRACTION SLASH = solidus (in typography)
⁅	LEFT SQUARE BRACKET WITH QUILL
⁆	RIGHT SQUARE BRACKET WITH QUILL
⁇	DOUBLE QUESTION MARK
⁈	QUESTION EXCLAMATION MARK
⁉	EXCLAMATION QUESTION MARK
⁊	TIRONIAN SIGN ET
⁋	REVERSED PILCROW SIGN
⁌	BLACK LEFTWARDS BULLET
⁍	BLACK RIGHTWARDS BULLET
⁎	LOW ASTERISK
⁏	REVERSED SEMICOLON
⁐	CLOSE UP
⁑	TWO ASTERISKS ALIGNED VERTICALLY
⁒	COMMERCIAL MINUS SIGN = abzüglich (German), med avdrag av (Swedish), piska (Swedish, "whip")
⁓	SWUNG DASH
⁔	INVERTED UNDERTIE
⁕	FLOWER PUNCTUATION MARK = phul, puspika
⁗	QUADRUPLE PRIME
⁰	SUPERSCRIPT ZERO
ⁱ	SUPERSCRIPT LATIN SMALL LETTER I
⁴	SUPERSCRIPT FOUR
⁵	SUPERSCRIPT FIVE
⁶	SUPERSCRIPT SIX
⁷	SUPERSCRIPT SEVEN
⁸	SUPERSCRIPT EIGHT
⁹	SUPERSCRIPT NINE
⁺	SUPERSCRIPT PLUS SIGN
⁻	SUPERSCRIPT MINUS
⁼	SUPERSCRIPT EQUALS SIGN
⁽	SUPERSCRIPT LEFT PARENTHESIS
⁾	SUPERSCRIPT RIGHT PARENTHESIS
ⁿ	SUPERSCRIPT LATIN SMALL LETTER N
₀	SUBSCRIPT ZERO
₁	SUBSCRIPT ONE
₂	SUBSCRIPT TWO
₃	SUBSCRIPT THREE
₄	SUBSCRIPT FOUR
₅	SUBSCRIPT FIVE
₆	SUBSCRIPT SIX
₇	SUBSCRIPT SEVEN
₈	SUBSCRIPT EIGHT
₉	SUBSCRIPT NINE
₊	SUBSCRIPT PLUS SIGN
₋	SUBSCRIPT MINUS
₌	SUBSCRIPT EQUALS SIGN
₍	SUBSCRIPT LEFT PARENTHESIS
₎	SUBSCRIPT RIGHT PARENTHESIS
₠	EURO-CURRENCY SIGN
₡	COLON SIGN
₢	CRUZEIRO SIGN
₣	FRENCH FRANC SIGN
₤	LIRA SIGN
₥	MILL SIGN
₦	NAIRA SIGN
₧	PESETA SIGN
₨	RUPEE SIGN
₩	WON SIGN
₪	NEW SHEQEL SIGN
₫	DONG SIGN
€	EURO SIGN
₭	KIP SIGN
₮	TUGRIK SIGN
₯	DRACHMA SIGN
₰	GERMAN PENNY SIGN
₱	PESO SIGN
₲	GUARANI SIGN
₳	AUSTRAL SIGN
₴	HRYVNIA SIGN
₵	CEDI SIGN
₶	LIVRE TOURNOIS SIGN
₷	SPESMILO SIGN
₸	TENGE SIGN
₹	INDIAN RUPEE SIGN
℀	ACCOUNT OF
℁	ADDRESSED TO THE SUBJECT
℃	DEGREE CELSIUS = degrees Centigrade
℄	CENTRE LINE SYMBOL = clone
℅	CARE OF
℆	CADA UNA
ℇ	EULER CONSTANT
℈	SCRUPLE
℉	DEGREE FAHRENHEIT
ℊ	SCRIPT SMALL G = real number symbol
ℋ	SCRIPT CAPITAL H = Hamiltonian operator
ℌ	BLACK-LETTER CAPITAL H = Hilbert space
ℍ	DOUBLE-STRUCK CAPITAL H
ℎ	PLANCK CONSTANT = height, specific enthalpy, ...
ℏ	PLANCK CONSTANT OVER TWO PI
ℐ	SCRIPT CAPITAL I
ℑ	BLACK-LETTER CAPITAL I = imaginary part
ℒ	SCRIPT CAPITAL L = Laplace transform
ℓ	SCRIPT SMALL L = mathematical symbol 'ell' = liter (traditional symbol)
℔	L B BAR SYMBOL = pounds
ℕ	DOUBLE-STRUCK CAPITAL N = natural number
№	NUMERO SIGN
℗	SOUND RECORDING COPYRIGHT = published = phonorecord sign
℘	SCRIPT CAPITAL P
ℙ	DOUBLE-STRUCK CAPITAL P
ℚ	DOUBLE-STRUCK CAPITAL Q = the set of rational numbers
ℛ	SCRIPT CAPITAL R = Riemann Integral
ℜ	BLACK-LETTER CAPITAL R = real part
ℝ	DOUBLE-STRUCK CAPITAL R = the set of real numbers
℞	PRESCRIPTION TAKE = recipe = cross ratio
℟	RESPONSE
℠	SERVICE MARK
℡	TELEPHONE SIGN
™	TRADE MARK SIGN
℣	VERSICLE
ℤ	DOUBLE-STRUCK CAPITAL Z = the set of integers
℥	OUNCE SIGN
Ω	OHM SIGN
℧	INVERTED OHM SIGN = mho
ℨ	BLACK-LETTER CAPITAL Z
℩	TURNED GREEK SMALL LETTER IOTA
K	KELVIN SIGN
Å	ANGSTROM SIGN
ℬ	SCRIPT CAPITAL B = Bernoulli function
ℭ	BLACK-LETTER CAPITAL C
℮	ESTIMATED SYMBOL
ℯ	SCRIPT SMALL E = error = natural exponent
ℰ	SCRIPT CAPITAL E = emf (electromotive force)
ℱ	SCRIPT CAPITAL F = Fourier transform
Ⅎ	TURNED CAPITAL F = Claudian digamma inversum
ℳ	SCRIPT CAPITAL M = M-matrix (physics) = German Mark currency symbol, before WWII
ℴ	SCRIPT SMALL O = order, of inferior order to
ℵ	ALEF SYMBOL = first transfinite cardinal (countable)
ℶ	BET SYMBOL = second transfinite cardinal (the continuum)
ℷ	GIMEL SYMBOL = third transfinite cardinal (functions of a real variable)
ℸ	DALET SYMBOL = fourth transfinite cardinal
⅁	TURNED SANS-SERIF CAPITAL G = game
⅂	TURNED SANS-SERIF CAPITAL L
⅃	REVERSED SANS-SERIF CAPITAL L
⅄	TURNED SANS-SERIF CAPITAL Y
ⅅ	DOUBLE-STRUCK ITALIC CAPITAL D
ⅆ	DOUBLE-STRUCK ITALIC SMALL D
ⅇ	DOUBLE-STRUCK ITALIC SMALL E
ⅈ	DOUBLE-STRUCK ITALIC SMALL I
ⅉ	DOUBLE-STRUCK ITALIC SMALL J
⅋	TURNED AMPERSAND
ⅎ	TURNED SMALL F
⅐	VULGAR FRACTION ONE SEVENTH
⅑	VULGAR FRACTION ONE NINTH
⅒	VULGAR FRACTION ONE TENTH
⅓	VULGAR FRACTION ONE THIRD
⅔	VULGAR FRACTION TWO THIRDS
⅕	VULGAR FRACTION ONE FIFTH
⅖	VULGAR FRACTION TWO FIFTHS
⅗	VULGAR FRACTION THREE FIFTHS
⅘	VULGAR FRACTION FOUR FIFTHS
⅙	VULGAR FRACTION ONE SIXTH
⅚	VULGAR FRACTION FIVE SIXTHS
⅛	VULGAR FRACTION ONE EIGHTH
⅜	VULGAR FRACTION THREE EIGHTHS
⅝	VULGAR FRACTION FIVE EIGHTHS
⅞	VULGAR FRACTION SEVEN EIGHTHS
⅟	FRACTION NUMERATOR ONE
Ⅰ	ROMAN NUMERAL ONE
Ⅱ	ROMAN NUMERAL TWO
Ⅲ	ROMAN NUMERAL THREE
Ⅳ	ROMAN NUMERAL FOUR
Ⅴ	ROMAN NUMERAL FIVE
Ⅵ	ROMAN NUMERAL SIX
Ⅶ	ROMAN NUMERAL SEVEN
Ⅷ	ROMAN NUMERAL EIGHT
Ⅸ	ROMAN NUMERAL NINE
Ⅹ	ROMAN NUMERAL TEN
Ⅺ	ROMAN NUMERAL ELEVEN
Ⅻ	ROMAN NUMERAL TWELVE
Ⅼ	ROMAN NUMERAL FIFTY
Ⅽ	ROMAN NUMERAL ONE HUNDRED
Ⅾ	ROMAN NUMERAL FIVE HUNDRED
Ⅿ	ROMAN NUMERAL ONE THOUSAND
ⅰ	SMALL ROMAN NUMERAL ONE
ⅱ	SMALL ROMAN NUMERAL TWO
ⅲ	SMALL ROMAN NUMERAL THREE
ⅳ	SMALL ROMAN NUMERAL FOUR
ⅴ	SMALL ROMAN NUMERAL FIVE
ⅵ	SMALL ROMAN NUMERAL SIX
ⅶ	SMALL ROMAN NUMERAL SEVEN
ⅷ	SMALL ROMAN NUMERAL EIGHT
ⅸ	SMALL ROMAN NUMERAL NINE
ⅹ	SMALL ROMAN NUMERAL TEN
ⅺ	SMALL ROMAN NUMERAL ELEVEN
ⅻ	SMALL ROMAN NUMERAL TWELVE
ⅼ	SMALL ROMAN NUMERAL FIFTY
ⅽ	SMALL ROMAN NUMERAL ONE HUNDRED
ⅾ	SMALL ROMAN NUMERAL FIVE HUNDRED
ⅿ	SMALL ROMAN NUMERAL ONE THOUSAND
ↄ	LATIN SMALL LETTER REVERSED C
←	LEFTWARDS ARROW
↑	UPWARDS ARROW
→	RIGHTWARDS ARROW = z notation total function
↓	DOWNWARDS ARROW
↔	LEFT RIGHT ARROW = z notation relation
↕	UP DOWN ARROW
↖	NORTH WEST ARROW
↗	NORTH EAST ARROW
↘	SOUTH EAST ARROW
↙	SOUTH WEST ARROW
↚	LEFTWARDS ARROW WITH STROKE
↛	RIGHTWARDS ARROW WITH STROKE
↜	LEFTWARDS WAVE ARROW
↝	RIGHTWARDS WAVE ARROW
↞	LEFTWARDS TWO HEADED ARROW = fast cursor left
↟	UPWARDS TWO HEADED ARROW = fast cursor up
↠	RIGHTWARDS TWO HEADED ARROW = z notation total surjection = fast cursor right
↡	DOWNWARDS TWO HEADED ARROW = form feed = fast cursor down
↢	LEFTWARDS ARROW WITH TAIL
↣	RIGHTWARDS ARROW WITH TAIL = z notation total injection
↤	LEFTWARDS ARROW FROM BAR
↥	UPWARDS ARROW FROM BAR
↦	RIGHTWARDS ARROW FROM BAR = z notation maplet
↧	DOWNWARDS ARROW FROM BAR = depth symbol
↨	UP DOWN ARROW WITH BASE
↩	LEFTWARDS ARROW WITH HOOK
↪	RIGHTWARDS ARROW WITH HOOK
↫	LEFTWARDS ARROW WITH LOOP
↬	RIGHTWARDS ARROW WITH LOOP
↭	LEFT RIGHT WAVE ARROW
↮	LEFT RIGHT ARROW WITH STROKE
↯	DOWNWARDS ZIGZAG ARROW = electrolysis
↰	UPWARDS ARROW WITH TIP LEFTWARDS
↱	UPWARDS ARROW WITH TIP RIGHTWARDS
↲	DOWNWARDS ARROW WITH TIP LEFTWARDS
↳	DOWNWARDS ARROW WITH TIP RIGHTWARDS
↴	RIGHTWARDS ARROW WITH CORNER DOWNWARDS = line feed
↵	DOWNWARDS ARROW WITH CORNER LEFTWARDS
↶	ANTICLOCKWISE TOP SEMICIRCLE ARROW
↷	CLOCKWISE TOP SEMICIRCLE ARROW
↸	NORTH WEST ARROW TO LONG BAR = home
↹	LEFTWARDS ARROW TO BAR OVER RIGHTWARDS ARROW TO BAR = tab with shift tab
↺	ANTICLOCKWISE OPEN CIRCLE ARROW
↻	CLOCKWISE OPEN CIRCLE ARROW
↼	LEFTWARDS HARPOON WITH BARB UPWARDS
↽	LEFTWARDS HARPOON WITH BARB DOWNWARDS
↾	UPWARDS HARPOON WITH BARB RIGHTWARDS
↿	UPWARDS HARPOON WITH BARB LEFTWARDS
⇀	RIGHTWARDS HARPOON WITH BARB UPWARDS
⇁	RIGHTWARDS HARPOON WITH BARB DOWNWARDS
⇂	DOWNWARDS HARPOON WITH BARB RIGHTWARDS
⇃	DOWNWARDS HARPOON WITH BARB LEFTWARDS
⇄	RIGHTWARDS ARROW OVER LEFTWARDS ARROW
⇅	UPWARDS ARROW LEFTWARDS OF DOWNWARDS ARROW
⇆	LEFTWARDS ARROW OVER RIGHTWARDS ARROW
⇇	LEFTWARDS PAIRED ARROWS
⇈	UPWARDS PAIRED ARROWS
⇉	RIGHTWARDS PAIRED ARROWS
⇊	DOWNWARDS PAIRED ARROWS
⇋	LEFTWARDS HARPOON OVER RIGHTWARDS HARPOON
⇌	RIGHTWARDS HARPOON OVER LEFTWARDS HARPOON
⇍	LEFTWARDS DOUBLE ARROW WITH STROKE
⇎	LEFT RIGHT DOUBLE ARROW WITH STROKE
⇏	RIGHTWARDS DOUBLE ARROW WITH STROKE
⇐	LEFTWARDS DOUBLE ARROW
⇑	UPWARDS DOUBLE ARROW
⇒	RIGHTWARDS DOUBLE ARROW
⇓	DOWNWARDS DOUBLE ARROW
⇔	LEFT RIGHT DOUBLE ARROW
⇕	UP DOWN DOUBLE ARROW
⇖	NORTH WEST DOUBLE ARROW
⇗	NORTH EAST DOUBLE ARROW
⇘	SOUTH EAST DOUBLE ARROW
⇙	SOUTH WEST DOUBLE ARROW
⇚	LEFTWARDS TRIPLE ARROW
⇛	RIGHTWARDS TRIPLE ARROW
⇜	LEFTWARDS SQUIGGLE ARROW
⇝	RIGHTWARDS SQUIGGLE ARROW
⇞	UPWARDS ARROW WITH DOUBLE STROKE = page up
⇟	DOWNWARDS ARROW WITH DOUBLE STROKE = page down
⇠	LEFTWARDS DASHED ARROW
⇡	UPWARDS DASHED ARROW
⇢	RIGHTWARDS DASHED ARROW
⇣	DOWNWARDS DASHED ARROW
⇤	LEFTWARDS ARROW TO BAR = leftward tab
⇥	RIGHTWARDS ARROW TO BAR = rightward tab
⇦	LEFTWARDS WHITE ARROW
⇧	UPWARDS WHITE ARROW = shift = level 2 select (ISO 9995-7)
⇨	RIGHTWARDS WHITE ARROW = group select (ISO 9995-7)
⇩	DOWNWARDS WHITE ARROW
⇪	UPWARDS WHITE ARROW FROM BAR = caps lock
⇫	UPWARDS WHITE ARROW ON PEDESTAL = level 2 lock
⇬	UPWARDS WHITE ARROW ON PEDESTAL WITH HORIZONTAL BAR = capitals (caps) lock
⇭	UPWARDS WHITE ARROW ON PEDESTAL WITH VERTICAL BAR = numeric lock
⇮	UPWARDS WHITE DOUBLE ARROW = level 3 select
⇯	UPWARDS WHITE DOUBLE ARROW ON PEDESTAL = level 3 lock
⇰	RIGHTWARDS WHITE ARROW FROM WALL = group lock
⇱	NORTH WEST ARROW TO CORNER = home
⇲	SOUTH EAST ARROW TO CORNER = end
⇳	UP DOWN WHITE ARROW = scrolling
⇴	RIGHT ARROW WITH SMALL CIRCLE
⇵	DOWNWARDS ARROW LEFTWARDS OF UPWARDS ARROW
⇶	THREE RIGHTWARDS ARROWS
⇷	LEFTWARDS ARROW WITH VERTICAL STROKE
⇸	RIGHTWARDS ARROW WITH VERTICAL STROKE = z notation partial function
⇹	LEFT RIGHT ARROW WITH VERTICAL STROKE = z notation partial relation
⇺	LEFTWARDS ARROW WITH DOUBLE VERTICAL STROKE
⇻	RIGHTWARDS ARROW WITH DOUBLE VERTICAL STROKE = z notation finite function
⇼	LEFT RIGHT ARROW WITH DOUBLE VERTICAL STROKE = z notation finite relation
⇽	LEFTWARDS OPEN-HEADED ARROW
⇾	RIGHTWARDS OPEN-HEADED ARROW
⇿	LEFT RIGHT OPEN-HEADED ARROW
∀	FOR ALL = universal quantifier
∁	COMPLEMENT
∂	PARTIAL DIFFERENTIAL
∃	THERE EXISTS = existential quantifier
∄	THERE DOES NOT EXIST
∅	EMPTY SET = null set
∆	INCREMENT = Laplace operator = forward difference = symmetric difference (in set theory)
∇	NABLA = backward difference = gradient, del
∈	ELEMENT OF
∉	NOT AN ELEMENT OF
∊	SMALL ELEMENT OF
∋	CONTAINS AS MEMBER = such that
∌	DOES NOT CONTAIN AS MEMBER
∍	SMALL CONTAINS AS MEMBER
∎	END OF PROOF = q.e.d.
∏	N-ARY PRODUCT = product sign
∐	N-ARY COPRODUCT = coproduct sign
∑	N-ARY SUMMATION = summation sign
−	MINUS SIGN
∓	MINUS-OR-PLUS SIGN
∔	DOT PLUS
∕	DIVISION SLASH
∖	SET MINUS
∗	ASTERISK OPERATOR
∘	RING OPERATOR = composite function = APL jot
∙	BULLET OPERATOR
√	SQUARE ROOT = radical sign
∛	CUBE ROOT
∜	FOURTH ROOT
∝	PROPORTIONAL TO
∞	INFINITY
∟	RIGHT ANGLE
∠	ANGLE
∡	MEASURED ANGLE
∢	SPHERICAL ANGLE = angle arc
∣	DIVIDES = such that = APL stile
∤	DOES NOT DIVIDE
∥	PARALLEL TO
∦	NOT PARALLEL TO
∧	LOGICAL AND = wedge, conjunction
∨	LOGICAL OR = vee, disjunction
∩	INTERSECTION = cap, hat
∪	UNION = cup
∫	INTEGRAL
∬	DOUBLE INTEGRAL
∭	TRIPLE INTEGRAL
∮	CONTOUR INTEGRAL
∯	SURFACE INTEGRAL
∰	VOLUME INTEGRAL
∱	CLOCKWISE INTEGRAL
∲	CLOCKWISE CONTOUR INTEGRAL
∳	ANTICLOCKWISE CONTOUR INTEGRAL
∴	THEREFORE (Freemason symbol - three dots - 3 points symbol). This 3 dos can also be &there4; in HTML.
∵	BECAUSE
∶	RATIO
∷	PROPORTION
∸	DOT MINUS = saturating subtraction
∹	EXCESS
∺	GEOMETRIC PROPORTION
∻	HOMOTHETIC
∼	TILDE OPERATOR = varies with (proportional to) = difference between = similar to = not = cycle = APL tilde
∽	REVERSED TILDE = lazy S
∾	INVERTED LAZY S = most positive
∿	SINE WAVE = alternating current
≀	WREATH PRODUCT
≁	NOT TILDE
≂	MINUS TILDE
≃	ASYMPTOTICALLY EQUAL TO
≄	NOT ASYMPTOTICALLY EQUAL TO
≅	APPROXIMATELY EQUAL TO
≆	APPROXIMATELY BUT NOT ACTUALLY EQUAL TO
≇	NEITHER APPROXIMATELY NOR ACTUALLY EQUAL TO
≈	ALMOST EQUAL TO = asymptotic to
≉	NOT ALMOST EQUAL TO
≊	ALMOST EQUAL OR EQUAL TO
≋	TRIPLE TILDE
≌	ALL EQUAL TO
≍	EQUIVALENT TO
≎	GEOMETRICALLY EQUIVALENT TO
≏	DIFFERENCE BETWEEN
≐	APPROACHES THE LIMIT
≑	GEOMETRICALLY EQUAL TO
≒	APPROXIMATELY EQUAL TO OR THE IMAGE OF = nearly equals
≓	IMAGE OF OR APPROXIMATELY EQUAL TO
≔	COLON EQUALS
≕	EQUALS COLON
≖	RING IN EQUAL TO
≗	RING EQUAL TO = approximately equal to
≘	CORRESPONDS TO
≙	ESTIMATES = corresponds to
≚	EQUIANGULAR TO
≛	STAR EQUALS
≜	DELTA EQUAL TO = equiangular = equal to by definition
≝	EQUAL TO BY DEFINITION
≞	MEASURED BY
≟	QUESTIONED EQUAL TO
≠	NOT EQUAL TO
≡	IDENTICAL TO
≢	NOT IDENTICAL TO
≣	STRICTLY EQUIVALENT TO
≤	LESS-THAN OR EQUAL TO
≦	LESS-THAN OVER EQUAL TO
≧	GREATER-THAN OVER EQUAL TO
≨	LESS-THAN BUT NOT EQUAL TO
≩	GREATER-THAN BUT NOT EQUAL TO
≪	MUCH LESS-THAN
≫	MUCH GREATER-THAN
≬	BETWEEN = plaintiff, quantic
≭	NOT EQUIVALENT TO
≮	NOT LESS-THAN
≯	NOT GREATER-THAN
≰	NEITHER LESS-THAN NOR EQUAL TO
≱	NEITHER GREATER-THAN NOR EQUAL TO
≲	LESS-THAN OR EQUIVALENT TO
≳	GREATER-THAN OR EQUIVALENT TO
≴	NEITHER LESS-THAN NOR EQUIVALENT TO
≵	NEITHER GREATER-THAN NOR EQUIVALENT TO
≶	LESS-THAN OR GREATER-THAN
≷	GREATER-THAN OR LESS-THAN
≸	NEITHER LESS-THAN NOR GREATER-THAN
≹	NEITHER GREATER-THAN NOR LESS-THAN
≺	PRECEDES = lower rank than
≻	SUCCEEDS = higher rank than
≼	PRECEDES OR EQUAL TO
≽	SUCCEEDS OR EQUAL TO
≾	PRECEDES OR EQUIVALENT TO
≿	SUCCEEDS OR EQUIVALENT TO
⊀	DOES NOT PRECEDE
⊁	DOES NOT SUCCEED
⊂	SUBSET OF = included in set
⊃	SUPERSET OF = includes in set
⊄	NOT A SUBSET OF
⊅	NOT A SUPERSET OF
⊆	SUBSET OF OR EQUAL TO
⊇	SUPERSET OF OR EQUAL TO
⊈	NEITHER A SUBSET OF NOR EQUAL TO
⊉	NEITHER A SUPERSET OF NOR EQUAL TO
⊊	SUBSET OF WITH NOT EQUAL TO
⊋	SUPERSET OF WITH NOT EQUAL TO
⊌	MULTISET
⊍	MULTISET MULTIPLICATION
⊎	MULTISET UNION = z notation bag addition
⊏	SQUARE IMAGE OF
⊐	SQUARE ORIGINAL OF
⊑	SQUARE IMAGE OF OR EQUAL TO
⊒	SQUARE ORIGINAL OF OR EQUAL TO
⊓	SQUARE CAP
⊔	SQUARE CUP
⊕	CIRCLED PLUS = direct sum = vector pointing into page
⊖	CIRCLED MINUS = symmetric difference
⊗	CIRCLED TIMES = tensor product = vector pointing into page
⊘	CIRCLED DIVISION SLASH
⊙	CIRCLED DOT OPERATOR = direct product = vector pointing out of page
⊚	CIRCLED RING OPERATOR
⊛	CIRCLED ASTERISK OPERATOR
⊜	CIRCLED EQUALS
⊝	CIRCLED DASH
⊞	SQUARED PLUS
⊟	SQUARED MINUS
⊠	SQUARED TIMES
⊡	SQUARED DOT OPERATOR
⊢	RIGHT TACK = turnstile = proves, implies, yields = reducible
⊣	LEFT TACK = reverse turnstile = non-theorem, does not yield
⊤	DOWN TACK = top
⊥	UP TACK = base, bottom
⊦	ASSERTION = reduces to
⊧	MODELS
⊨	TRUE = statement is true, valid = is a tautology = satisfies = results in
⊩	FORCES
⊪	TRIPLE VERTICAL BAR RIGHT TURNSTILE
⊫	DOUBLE VERTICAL BAR DOUBLE RIGHT TURNSTILE
⊬	DOES NOT PROVE
⊭	NOT TRUE
⊮	DOES NOT FORCE
⊯	NEGATED DOUBLE VERTICAL BAR DOUBLE RIGHT TURNSTILE
⊰	PRECEDES UNDER RELATION
⊱	SUCCEEDS UNDER RELATION
⊲	NORMAL SUBGROUP OF
⊳	CONTAINS AS NORMAL SUBGROUP
⊴	NORMAL SUBGROUP OF OR EQUAL TO
⊵	CONTAINS AS NORMAL SUBGROUP OR EQUAL TO
⊶	ORIGINAL OF
⊷	IMAGE OF
⊸	MULTIMAP
⊹	HERMITIAN CONJUGATE MATRIX
⊺	INTERCALATE
⊻	XOR
⊼	NAND
⊽	NOR
⊾	RIGHT ANGLE WITH ARC
⊿	RIGHT TRIANGLE
⋀	N-ARY LOGICAL AND
⋁	N-ARY LOGICAL OR
⋂	N-ARY INTERSECTION = z notation generalised intersection
⋃	N-ARY UNION = z notation generalised union
⋄	DIAMOND OPERATOR
⋅	DOT OPERATOR
⋆	STAR OPERATOR
⋇	DIVISION TIMES
⋈	BOWTIE
⋉	LEFT NORMAL FACTOR SEMIDIRECT PRODUCT
⋊	RIGHT NORMAL FACTOR SEMIDIRECT PRODUCT
⋋	LEFT SEMIDIRECT PRODUCT
⋌	RIGHT SEMIDIRECT PRODUCT
⋍	REVERSED TILDE EQUALS
⋎	CURLY LOGICAL OR
⋏	CURLY LOGICAL AND
⋐	DOUBLE SUBSET
⋑	DOUBLE SUPERSET
⋒	DOUBLE INTERSECTION
⋓	DOUBLE UNION
⋔	PITCHFORK = proper intersection
⋕	EQUAL AND PARALLEL TO
⋖	LESS-THAN WITH DOT
⋗	GREATER-THAN WITH DOT
⋘	VERY MUCH LESS-THAN
⋙	VERY MUCH GREATER-THAN
⋚	LESS-THAN EQUAL TO OR GREATER-THAN
⋛	GREATER-THAN EQUAL TO OR LESS-THAN
⋜	EQUAL TO OR LESS-THAN
⋝	EQUAL TO OR GREATER-THAN
⋞	EQUAL TO OR PRECEDES
⋟	EQUAL TO OR SUCCEEDS
⋠	DOES NOT PRECEDE OR EQUAL
⋡	DOES NOT SUCCEED OR EQUAL
⋢	NOT SQUARE IMAGE OF OR EQUAL TO
⋣	NOT SQUARE ORIGINAL OF OR EQUAL TO
⋤	SQUARE IMAGE OF OR NOT EQUAL TO
⋥	SQUARE ORIGINAL OF OR NOT EQUAL TO
⋦	LESS-THAN BUT NOT EQUIVALENT TO
⋧	GREATER-THAN BUT NOT EQUIVALENT TO
⋨	PRECEDES BUT NOT EQUIVALENT TO
⋩	SUCCEEDS BUT NOT EQUIVALENT TO
⋪	NOT NORMAL SUBGROUP OF
⋫	DOES NOT CONTAIN AS NORMAL SUBGROUP
⋬	NOT NORMAL SUBGROUP OF OR EQUAL TO
⋭	DOES NOT CONTAIN AS NORMAL SUBGROUP OR EQUAL
⋮	VERTICAL ELLIPSIS
⋯	MIDLINE HORIZONTAL ELLIPSIS
⋰	UP RIGHT DIAGONAL ELLIPSIS
⋱	DOWN RIGHT DIAGONAL ELLIPSIS
⌀	DIAMETER SIGN
⌂	HOUSE
⌃	UP ARROWHEAD
⌄	DOWN ARROWHEAD
⌅	PROJECTIVE
⌆	PERSPECTIVE
⌇	WAVY LINE
⌈	LEFT CEILING = APL upstile
⌉	RIGHT CEILING
⌊	LEFT FLOOR = APL downstile
⌋	RIGHT FLOOR
⌐	REVERSED NOT SIGN = beginning of line
⌑	SQUARE LOZENGE = Kissen (pillow)
⌒	ARC = position of any line
⌓	SEGMENT = position of a surface
⌔	SECTOR
⌕	TELEPHONE RECORDER
⌖	POSITION INDICATOR = true position
⌗	VIEWDATA SQUARE
⌘	PLACE OF INTEREST SIGN = command key = operating system key (ISO 9995-7)
⌙	TURNED NOT SIGN = line marker
⌚	WATCH
⌛	HOURGLASS = alchemical symbol for hour
⌠	TOP HALF INTEGRAL
⌡	BOTTOM HALF INTEGRAL
⌢	FROWN
⌣	SMILE
⌤	UP ARROWHEAD BETWEEN TWO HORIZONTAL BARS = enter key
⌥	OPTION KEY
⌦	ERASE TO THE RIGHT = delete to the right key
⌧	X IN A RECTANGLE BOX = clear key
⌨	KEYBOARD
⌫	ERASE TO THE LEFT = delete to the left key
⌬	BENZENE RING
⎛	LEFT PARENTHESIS UPPER HOOK
⎝	LEFT PARENTHESIS LOWER HOOK
⎞	RIGHT PARENTHESIS UPPER HOOK
⎟	RIGHT PARENTHESIS EXTENSION
⎠	RIGHT PARENTHESIS LOWER HOOK
⎡	LEFT SQUARE BRACKET UPPER CORNER
⎢	LEFT SQUARE BRACKET EXTENSION
⎣	LEFT SQUARE BRACKET LOWER CORNER
⎤	RIGHT SQUARE BRACKET UPPER CORNER
⎥	RIGHT SQUARE BRACKET EXTENSION
⎦	RIGHT SQUARE BRACKET LOWER CORNER
⎧	LEFT CURLY BRACKET UPPER HOOK
⎨	LEFT CURLY BRACKET MIDDLE PIECE
⎩	LEFT CURLY BRACKET LOWER HOOK
⎪	CURLY BRACKET EXTENSION
⎫	RIGHT CURLY BRACKET UPPER HOOK
⎭	RIGHT CURLY BRACKET LOWER HOOK
⏎	RETURN SYMBOL
⏏	EJECT SYMBOL
⏚	EARTH GROUND
⏛	FUSE
⏰	ALARM CLOCK
⏱	STOPWATCH
⏲	TIMER CLOCK
⏳	HOURGLASS WITH FLOWING SAND
␢	BLANK SYMBOL
␣	OPEN BOX
━	BOX DRAWINGS HEAVY HORIZONTAL
│	BOX DRAWINGS LIGHT VERTICAL = Videotex Mosaic DG 14
┃	BOX DRAWINGS HEAVY VERTICAL
┄	BOX DRAWINGS LIGHT TRIPLE DASH HORIZONTAL
┅	BOX DRAWINGS HEAVY TRIPLE DASH HORIZONTAL
┆	BOX DRAWINGS LIGHT TRIPLE DASH VERTICAL
┉	BOX DRAWINGS HEAVY QUADRUPLE DASH HORIZONTAL
┊	BOX DRAWINGS LIGHT QUADRUPLE DASH VERTICAL
┋	BOX DRAWINGS HEAVY QUADRUPLE DASH VERTICAL
┌	BOX DRAWINGS LIGHT DOWN AND RIGHT = Videotex Mosaic DG 16
┍	BOX DRAWINGS DOWN LIGHT AND RIGHT HEAVY
┎	BOX DRAWINGS DOWN HEAVY AND RIGHT LIGHT
┏	BOX DRAWINGS HEAVY DOWN AND RIGHT
┐	BOX DRAWINGS LIGHT DOWN AND LEFT = Videotex Mosaic DG 17
┑	BOX DRAWINGS DOWN LIGHT AND LEFT HEAVY
┒	BOX DRAWINGS DOWN HEAVY AND LEFT LIGHT
┓	BOX DRAWINGS HEAVY DOWN AND LEFT
└	BOX DRAWINGS LIGHT UP AND RIGHT = Videotex Mosaic DG 18
┕	BOX DRAWINGS UP LIGHT AND RIGHT HEAVY
┖	BOX DRAWINGS UP HEAVY AND RIGHT LIGHT
┗	BOX DRAWINGS HEAVY UP AND RIGHT
┘	BOX DRAWINGS LIGHT UP AND LEFT = Videotex Mosaic DG 19
┙	BOX DRAWINGS UP LIGHT AND LEFT HEAVY
┚	BOX DRAWINGS UP HEAVY AND LEFT LIGHT
┛	BOX DRAWINGS HEAVY UP AND LEFT
├	BOX DRAWINGS LIGHT VERTICAL AND RIGHT = Videotex Mosaic DG 20
┞	BOX DRAWINGS UP HEAVY AND RIGHT DOWN LIGHT
┟	BOX DRAWINGS DOWN HEAVY AND RIGHT UP LIGHT
┠	BOX DRAWINGS VERTICAL HEAVY AND RIGHT LIGHT
┡	BOX DRAWINGS DOWN LIGHT AND RIGHT UP HEAVY
┢	BOX DRAWINGS UP LIGHT AND RIGHT DOWN HEAVY
┣	BOX DRAWINGS HEAVY VERTICAL AND RIGHT
┤	BOX DRAWINGS LIGHT VERTICAL AND LEFT = Videotex Mosaic DG 21
┦	BOX DRAWINGS UP HEAVY AND LEFT DOWN LIGHT
┧	BOX DRAWINGS DOWN HEAVY AND LEFT UP LIGHT
┨	BOX DRAWINGS VERTICAL HEAVY AND LEFT LIGHT
┩	BOX DRAWINGS DOWN LIGHT AND LEFT UP HEAVY
┪	BOX DRAWINGS UP LIGHT AND LEFT DOWN HEAVY
┬	BOX DRAWINGS LIGHT DOWN AND HORIZONTAL = Videotex Mosaic DG 22
┭	BOX DRAWINGS LEFT HEAVY AND RIGHT DOWN LIGHT
┮	BOX DRAWINGS RIGHT HEAVY AND LEFT DOWN LIGHT
┯	BOX DRAWINGS DOWN LIGHT AND HORIZONTAL HEAVY = Videotex Mosaic DG 02
┰	BOX DRAWINGS DOWN HEAVY AND HORIZONTAL LIGHT
┱	BOX DRAWINGS RIGHT LIGHT AND LEFT DOWN HEAVY
┲	BOX DRAWINGS LEFT LIGHT AND RIGHT DOWN HEAVY
┳	BOX DRAWINGS HEAVY DOWN AND HORIZONTAL
┴	BOX DRAWINGS LIGHT UP AND HORIZONTAL = Videotex Mosaic DG 23
┵	BOX DRAWINGS LEFT HEAVY AND RIGHT UP LIGHT
┶	BOX DRAWINGS RIGHT HEAVY AND LEFT UP LIGHT
┷	BOX DRAWINGS UP LIGHT AND HORIZONTAL HEAVY = Videotex Mosaic DG 01
┸	BOX DRAWINGS UP HEAVY AND HORIZONTAL LIGHT
┹	BOX DRAWINGS RIGHT LIGHT AND LEFT UP HEAVY
┺	BOX DRAWINGS LEFT LIGHT AND RIGHT UP HEAVY
┻	BOX DRAWINGS HEAVY UP AND HORIZONTAL
┼	BOX DRAWINGS LIGHT VERTICAL AND HORIZONTAL = Videotex Mosaic DG 24
┽	BOX DRAWINGS LEFT HEAVY AND RIGHT VERTICAL LIGHT
┾	BOX DRAWINGS RIGHT HEAVY AND LEFT VERTICAL LIGHT
┿	BOX DRAWINGS VERTICAL LIGHT AND HORIZONTAL HEAVY = Videotex Mosaic DG 13
╀	BOX DRAWINGS UP HEAVY AND DOWN HORIZONTAL LIGHT
╁	BOX DRAWINGS DOWN HEAVY AND UP HORIZONTAL LIGHT
╂	BOX DRAWINGS VERTICAL HEAVY AND HORIZONTAL LIGHT
╃	BOX DRAWINGS LEFT UP HEAVY AND RIGHT DOWN LIGHT
╄	BOX DRAWINGS RIGHT UP HEAVY AND LEFT DOWN LIGHT
╅	BOX DRAWINGS LEFT DOWN HEAVY AND RIGHT UP LIGHT
╆	BOX DRAWINGS RIGHT DOWN HEAVY AND LEFT UP LIGHT
╇	BOX DRAWINGS DOWN LIGHT AND UP HORIZONTAL HEAVY
╈	BOX DRAWINGS UP LIGHT AND DOWN HORIZONTAL HEAVY
╉	BOX DRAWINGS RIGHT LIGHT AND LEFT VERTICAL HEAVY
╊	BOX DRAWINGS LEFT LIGHT AND RIGHT VERTICAL HEAVY
╋	BOX DRAWINGS HEAVY VERTICAL AND HORIZONTAL
╌	BOX DRAWINGS LIGHT DOUBLE DASH HORIZONTAL
╎	BOX DRAWINGS LIGHT DOUBLE DASH VERTICAL
╏	BOX DRAWINGS HEAVY DOUBLE DASH VERTICAL
═	BOX DRAWINGS DOUBLE HORIZONTAL
║	BOX DRAWINGS DOUBLE VERTICAL
╒	BOX DRAWINGS DOWN SINGLE AND RIGHT DOUBLE
╓	BOX DRAWINGS DOWN DOUBLE AND RIGHT SINGLE
╔	BOX DRAWINGS DOUBLE DOWN AND RIGHT
╕	BOX DRAWINGS DOWN SINGLE AND LEFT DOUBLE
╖	BOX DRAWINGS DOWN DOUBLE AND LEFT SINGLE
╗	BOX DRAWINGS DOUBLE DOWN AND LEFT
╘	BOX DRAWINGS UP SINGLE AND RIGHT DOUBLE
╙	BOX DRAWINGS UP DOUBLE AND RIGHT SINGLE
╚	BOX DRAWINGS DOUBLE UP AND RIGHT
╛	BOX DRAWINGS UP SINGLE AND LEFT DOUBLE
╜	BOX DRAWINGS UP DOUBLE AND LEFT SINGLE
╝	BOX DRAWINGS DOUBLE UP AND LEFT
╞	BOX DRAWINGS VERTICAL SINGLE AND RIGHT DOUBLE
╟	BOX DRAWINGS VERTICAL DOUBLE AND RIGHT SINGLE
╠	BOX DRAWINGS DOUBLE VERTICAL AND RIGHT
╡	BOX DRAWINGS VERTICAL SINGLE AND LEFT DOUBLE
╢	BOX DRAWINGS VERTICAL DOUBLE AND LEFT SINGLE
╣	BOX DRAWINGS DOUBLE VERTICAL AND LEFT
╤	BOX DRAWINGS DOWN SINGLE AND HORIZONTAL DOUBLE
╥	BOX DRAWINGS DOWN DOUBLE AND HORIZONTAL SINGLE
╦	BOX DRAWINGS DOUBLE DOWN AND HORIZONTAL
╧	BOX DRAWINGS UP SINGLE AND HORIZONTAL DOUBLE
╨	BOX DRAWINGS UP DOUBLE AND HORIZONTAL SINGLE
╩	BOX DRAWINGS DOUBLE UP AND HORIZONTAL
╪	BOX DRAWINGS VERTICAL SINGLE AND HORIZONTAL DOUBLE
╫	BOX DRAWINGS VERTICAL DOUBLE AND HORIZONTAL SINGLE
╬	BOX DRAWINGS DOUBLE VERTICAL AND HORIZONTAL
╮	BOX DRAWINGS LIGHT ARC DOWN AND LEFT
╯	BOX DRAWINGS LIGHT ARC UP AND LEFT
╱	BOX DRAWINGS LIGHT DIAGONAL UPPER RIGHT TO LOWER LEFT
╲	BOX DRAWINGS LIGHT DIAGONAL UPPER LEFT TO LOWER RIGHT
╳	BOX DRAWINGS LIGHT DIAGONAL CROSS
╴	BOX DRAWINGS LIGHT LEFT
╵	BOX DRAWINGS LIGHT UP
╶	BOX DRAWINGS LIGHT RIGHT
╷	BOX DRAWINGS LIGHT DOWN
╸	BOX DRAWINGS HEAVY LEFT
╹	BOX DRAWINGS HEAVY UP
╺	BOX DRAWINGS HEAVY RIGHT
╻	BOX DRAWINGS HEAVY DOWN
╽	BOX DRAWINGS LIGHT UP AND HEAVY DOWN
╾	BOX DRAWINGS HEAVY LEFT AND LIGHT RIGHT
╿	BOX DRAWINGS HEAVY UP AND LIGHT DOWN
▀	UPPER HALF BLOCK
▁	LOWER ONE EIGHTH BLOCK
▂	LOWER ONE QUARTER BLOCK
▃	LOWER THREE EIGHTHS BLOCK
▄	LOWER HALF BLOCK
▅	LOWER FIVE EIGHTHS BLOCK
▆	LOWER THREE QUARTERS BLOCK
▇	LOWER SEVEN EIGHTHS BLOCK
▉	LEFT SEVEN EIGHTHS BLOCK
▊	LEFT THREE QUARTERS BLOCK
▋	LEFT FIVE EIGHTHS BLOCK
▌	LEFT HALF BLOCK
▍	LEFT THREE EIGHTHS BLOCK
▏	LEFT ONE EIGHTH BLOCK
▐	RIGHT HALF BLOCK
░	LIGHT SHADE
▒	MEDIUM SHADE
▓	DARK SHADE
▔	UPPER ONE EIGHTH BLOCK
▕	RIGHT ONE EIGHTH BLOCK
▖	QUADRANT LOWER LEFT
▗	QUADRANT LOWER RIGHT
▘	QUADRANT UPPER LEFT
▙	QUADRANT UPPER LEFT AND LOWER LEFT AND LOWER RIGHT
▚	QUADRANT UPPER LEFT AND LOWER RIGHT
▛	QUADRANT UPPER LEFT AND UPPER RIGHT AND LOWER LEFT
▜	QUADRANT UPPER LEFT AND UPPER RIGHT AND LOWER RIGHT
▝	QUADRANT UPPER RIGHT
▞	QUADRANT UPPER RIGHT AND LOWER LEFT
▟	QUADRANT UPPER RIGHT AND LOWER LEFT AND LOWER RIGHT
■	BLACK SQUARE = moding mark (in ideographic text)
□	WHITE SQUARE = quadrature = alchemical symbol for salt
▢	WHITE SQUARE WITH ROUNDED CORNERS
▣	WHITE SQUARE CONTAINING BLACK SMALL SQUARE
▤	SQUARE WITH HORIZONTAL FILL
▥	SQUARE WITH VERTICAL FILL
▦	SQUARE WITH ORTHOGONAL CROSSHATCH FILL
▧	SQUARE WITH UPPER LEFT TO LOWER RIGHT FILL
▨	SQUARE WITH UPPER RIGHT TO LOWER LEFT FILL
▩	SQUARE WITH DIAGONAL CROSSHATCH FILL
▪	BLACK SMALL SQUARE = square bullet
▫	WHITE SMALL SQUARE
▬	BLACK RECTANGLE
▭	WHITE RECTANGLE
▮	BLACK VERTICAL RECTANGLE = histogram marker
▯	WHITE VERTICAL RECTANGLE
▰	BLACK PARALLELOGRAM
▱	WHITE PARALLELOGRAM
▲	BLACK UP-POINTING TRIANGLE
△	WHITE UP-POINTING TRIANGLE = trine
▴	BLACK UP-POINTING SMALL TRIANGLE
▵	WHITE UP-POINTING SMALL TRIANGLE
▷	WHITE RIGHT-POINTING TRIANGLE = z notation range restriction
▸	BLACK RIGHT-POINTING SMALL TRIANGLE
▹	WHITE RIGHT-POINTING SMALL TRIANGLE
▻	WHITE RIGHT-POINTING POINTER = forward arrow indicator
▼	BLACK DOWN-POINTING TRIANGLE
▽	WHITE DOWN-POINTING TRIANGLE = Hamilton operator
▾	BLACK DOWN-POINTING SMALL TRIANGLE
▿	WHITE DOWN-POINTING SMALL TRIANGLE
◀	BLACK LEFT-POINTING TRIANGLE
◁	WHITE LEFT-POINTING TRIANGLE = z notation domain restriction
◂	BLACK LEFT-POINTING SMALL TRIANGLE
◃	WHITE LEFT-POINTING SMALL TRIANGLE
◄	BLACK LEFT-POINTING POINTER
◅	WHITE LEFT-POINTING POINTER = backward arrow indicator
◆	BLACK DIAMOND
◇	WHITE DIAMOND
◈	WHITE DIAMOND CONTAINING BLACK SMALL DIAMOND
◊	LOZENGE
○	WHITE CIRCLE
◌	DOTTED CIRCLE
◍	CIRCLE WITH VERTICAL FILL
◎	BULLSEYE
●	BLACK CIRCLE
◐	CIRCLE WITH LEFT HALF BLACK
◑	CIRCLE WITH RIGHT HALF BLACK
◒	CIRCLE WITH LOWER HALF BLACK
◓	CIRCLE WITH UPPER HALF BLACK
◔	CIRCLE WITH UPPER RIGHT QUADRANT BLACK
◕	CIRCLE WITH ALL BUT UPPER LEFT QUADRANT BLACK
◖	LEFT HALF BLACK CIRCLE
◗	RIGHT HALF BLACK CIRCLE
◘	INVERSE BULLET
◙	INVERSE WHITE CIRCLE
◚	UPPER HALF INVERSE WHITE CIRCLE
◛	LOWER HALF INVERSE WHITE CIRCLE
◜	UPPER LEFT QUADRANT CIRCULAR ARC
◝	UPPER RIGHT QUADRANT CIRCULAR ARC
◞	LOWER RIGHT QUADRANT CIRCULAR ARC
◟	LOWER LEFT QUADRANT CIRCULAR ARC
◠	UPPER HALF CIRCLE
◡	LOWER HALF CIRCLE
◢	BLACK LOWER RIGHT TRIANGLE
◣	BLACK LOWER LEFT TRIANGLE
◤	BLACK UPPER LEFT TRIANGLE
◥	BLACK UPPER RIGHT TRIANGLE
◦	WHITE BULLET
◧	SQUARE WITH LEFT HALF BLACK
◨	SQUARE WITH RIGHT HALF BLACK
◩	SQUARE WITH UPPER LEFT DIAGONAL HALF BLACK
◪	SQUARE WITH LOWER RIGHT DIAGONAL HALF BLACK
◫	WHITE SQUARE WITH VERTICAL BISECTING LINE
◬	WHITE UP-POINTING TRIANGLE WITH DOT
◭	UP-POINTING TRIANGLE WITH LEFT HALF BLACK
◮	UP-POINTING TRIANGLE WITH RIGHT HALF BLACK
◯	LARGE CIRCLE
◰	WHITE SQUARE WITH UPPER LEFT QUADRANT
◱	WHITE SQUARE WITH LOWER LEFT QUADRANT
◲	WHITE SQUARE WITH LOWER RIGHT QUADRANT
◳	WHITE SQUARE WITH UPPER RIGHT QUADRANT
◴	WHITE CIRCLE WITH UPPER LEFT QUADRANT
◵	WHITE CIRCLE WITH LOWER LEFT QUADRANT
◶	WHITE CIRCLE WITH LOWER RIGHT QUADRANT
◷	WHITE CIRCLE WITH UPPER RIGHT QUADRANT
◸	UPPER LEFT TRIANGLE
◹	UPPER RIGHT TRIANGLE
◺	LOWER LEFT TRIANGLE
◻	WHITE MEDIUM SQUARE = always (modal operator)
◼	BLACK MEDIUM SQUARE
◽	WHITE MEDIUM SMALL SQUARE
◾	BLACK MEDIUM SMALL SQUARE
◿	LOWER RIGHT TRIANGLE
☀	BLACK SUN WITH RAYS = clear weather
☁	CLOUD = cloudy weather
☂	UMBRELLA = rainy weather
☃	SNOWMAN = snowy weather
☄	COMET
★	BLACK STAR
☆	WHITE STAR
☇	LIGHTNING
☈	THUNDERSTORM
☉	SUN = alchemical symbol for gold
☊	ASCENDING NODE = alchemical symbol for sublimate
☋	DESCENDING NODE = alchemical symbol for purify
☌	CONJUNCTION = alchemical symbol for day
☍	OPPOSITION
☎	BLACK TELEPHONE
☏	WHITE TELEPHONE
☐	BALLOT BOX
☑	BALLOT BOX WITH CHECK
☒	BALLOT BOX WITH X
☓	SALTIRE = St. Andrew's Cross
☔	UMBRELLA WITH RAIN DROPS = showery weather
☕	HOT BEVERAGE = tea or coffee, depending on locale
☖	WHITE SHOGI PIECE
☗	BLACK SHOGI PIECE
☘	SHAMROCK
☙	REVERSED ROTATED FLORAL HEART BULLET
☚	BLACK LEFT POINTING INDEX
☜	WHITE LEFT POINTING INDEX
☝	WHITE UP POINTING INDEX
☟	WHITE DOWN POINTING INDEX
☠	SKULL AND CROSSBONES (poison)
☡	CAUTION SIGN
☢	RADIOACTIVE SIGN
☣	BIOHAZARD SIGN
☤	CADUCEUS
☥	ANKH
☦	ORTHODOX CROSS
☧	CHI RHO = Constantine's cross, Christogram
☨	CROSS OF LORRAINE
☩	CROSS OF JERUSALEM
☪	STAR AND CRESCENT
☫	FARSI SYMBOL = symbol of iran
☬	ADI SHAKTI = Gurmukhi khanda
☭	HAMMER AND SICKLE
☮	PEACE SYMBOL
☯	YIN YANG
☰	TRIGRAM FOR HEAVEN = qian2
☱	TRIGRAM FOR LAKE = dui4
☲	TRIGRAM FOR FIRE = li2
☳	TRIGRAM FOR THUNDER = zhen4
☴	TRIGRAM FOR WIND = xun4
☵	TRIGRAM FOR WATER = kan3
☶	TRIGRAM FOR MOUNTAIN = gen4
☷	TRIGRAM FOR EARTH = kun1
☸	WHEEL OF DHARMA
☹	WHITE FROWNING FACE
☺	WHITE SMILING FACE = have a nice day!
☻	BLACK SMILING FACE
☼	WHITE SUN WITH RAYS = compass
☽	FIRST QUARTER MOON = alchemical symbol for silver
☾	LAST QUARTER MOON = alchemical symbol for silver
☿	MERCURY = alchemical symbol for quicksilver
♀	FEMALE SIGN = Venus = alchemical symbol for copper
♁	EARTH = alchemical symbol for antimony
♂	MALE SIGN = Mars = alchemical symbol for iron
♃	JUPITER = alchemical symbol for tin
♄	SATURN = alchemical symbol for lead
♅	URANUS
♆	NEPTUNE = alchemical symbol for bismuth/tinglass
♇	PLUTO
♈	ARIES
♉	TAURUS
♊	GEMINI
♋	CANCER
♌	LEO
♍	VIRGO = minim (alternate glyph)
♎	LIBRA
♏	SCORPIUS = scorpio = minim, drop
♐	SAGITTARIUS
♑	CAPRICORN
♒	AQUARIUS
♓	PISCES
♔	WHITE CHESS KING
♕	WHITE CHESS QUEEN
♖	WHITE CHESS ROOK
♗	WHITE CHESS BISHOP
♘	WHITE CHESS KNIGHT
♙	WHITE CHESS PAWN
♚	BLACK CHESS KING
♛	BLACK CHESS QUEEN
♜	BLACK CHESS ROOK
♝	BLACK CHESS BISHOP
♞	BLACK CHESS KNIGHT
♟	BLACK CHESS PAWN
♠	BLACK SPADE SUIT
♡	WHITE HEART SUIT
♢	WHITE DIAMOND SUIT
♣	BLACK CLUB SUIT
♤	WHITE SPADE SUIT
♥	BLACK HEART SUIT = valentine
♦	BLACK DIAMOND SUIT
♧	WHITE CLUB SUIT
♨	HOT SPRINGS
♩	QUARTER NOTE = crotchet
♪	EIGHTH NOTE = quaver
♫	BEAMED EIGHTH NOTES = beamed quavers
♬	BEAMED SIXTEENTH NOTES = beamed semiquavers
♭	MUSIC FLAT SIGN
♮	MUSIC NATURAL SIGN
♯	MUSIC SHARP SIGN = z notation infix bag count
♲	UNIVERSAL RECYCLING SYMBOL
♳	RECYCLING SYMBOL FOR TYPE-1 PLASTICS
♴	RECYCLING SYMBOL FOR TYPE-2 PLASTICS
♵	RECYCLING SYMBOL FOR TYPE-3 PLASTICS
♶	RECYCLING SYMBOL FOR TYPE-4 PLASTICS
♷	RECYCLING SYMBOL FOR TYPE-5 PLASTICS
♸	RECYCLING SYMBOL FOR TYPE-6 PLASTICS
♹	RECYCLING SYMBOL FOR TYPE-7 PLASTICS
♺	RECYCLING SYMBOL FOR GENERIC MATERIALS
♻	BLACK UNIVERSAL RECYCLING SYMBOL
♼	RECYCLED PAPER SYMBOL
♽	PARTIALLY-RECYCLED PAPER SYMBOL
♾	PERMANENT PAPER SIGN
♿	WHEELCHAIR SYMBOL
⚀	DIE FACE-1
⚁	DIE FACE-2
⚂	DIE FACE-3
⚃	DIE FACE-4
⚄	DIE FACE-5
⚅	DIE FACE-6
⚐	WHITE FLAG
⚑	BLACK FLAG
⚒	HAMMER AND PICK = mining, working day (in timetables)
⚓	ANCHOR = nautical term, harbor (on maps)
⚔	CROSSED SWORDS = military term, battleground (on maps), killed in action
⚕	STAFF OF AESCULAPIUS = medical term
⚖	SCALES = legal term, jurisprudence
⚗	ALEMBIC = chemical term, chemistry
⚘	FLOWER = botanical term
⚙	GEAR = technology, tools
⚚	STAFF OF HERMES
⚛	ATOM SYMBOL = nuclear installation (on maps)
⚜	FLEUR-DE-LIS
⚝	OUTLINED WHITE STAR
⚞	THREE LINES CONVERGING RIGHT = someone speaking
⚟	THREE LINES CONVERGING LEFT = background speaking
⚠	WARNING SIGN
⚢	DOUBLED FEMALE SIGN = lesbianism
⚣	DOUBLED MALE SIGN = male homosexuality
⚤	INTERLOCKED FEMALE AND MALE SIGN = bisexuality
⚥	MALE AND FEMALE SIGN = transgendered sexuality = hermaphrodite (in entomology)
⚦	MALE WITH STROKE SIGN = transgendered sexuality = alchemical symbol for iron or crocus of iron
⚧	MALE WITH STROKE AND MALE AND FEMALE SIGN = transgendered sexuality
⚨	VERTICAL MALE WITH STROKE SIGN = alchemical symbol for iron
⚩	HORIZONTAL MALE WITH STROKE SIGN = alchemical symbol for iron
⚪	MEDIUM WHITE CIRCLE = asexuality, sexless, genderless = engaged, betrothed
⚬	MEDIUM SMALL WHITE CIRCLE = engaged, betrothed (genealogy)
⚭	MARRIAGE SYMBOL
⚮	DIVORCE SYMBOL
⚯	UNMARRIED PARTNERSHIP SYMBOL
⚰	COFFIN = buried (genealogy)
⚱	FUNERAL URN = cremated (genealogy)
⚲	NEUTER
⚳	CERES
⚴	PALLAS
⚵	JUNO
⚶	VESTA
⚷	CHIRON
⚸	BLACK MOON LILITH
⚹	SEXTILE
⚺	SEMISEXTILE
⚻	QUINCUNX
⚼	SESQUIQUADRATE
⛀	WHITE DRAUGHTS MAN
⛁	WHITE DRAUGHTS KING
⛂	BLACK DRAUGHTS MAN
⛃	BLACK DRAUGHTS KING
⛢	ASTRONOMICAL SYMBOL FOR URANUS
⛤	PENTAGRAM = pentalpha, pentangle
⛥	RIGHT-HANDED INTERLACED PENTAGRAM
⛦	LEFT-HANDED INTERLACED PENTAGRAM
⛧	INVERTED PENTAGRAM
⛨	BLACK CROSS ON SHIELD = hospital
⛩	SHINTO SHRINE = torii
⛪	CHURCH
⛫	CASTLE
⛬	HISTORIC SITE
⛭	GEAR WITHOUT HUB = factory
⛮	GEAR WITH HANDLES = power plant, power substation
⛯	MAP SYMBOL FOR LIGHTHOUSE
⛰	MOUNTAIN
⛱	UMBRELLA ON GROUND = bathing beach
⛲	FOUNTAIN = park
⛳	FLAG IN HOLE = golf course
⛴	FERRY = ferry boat terminal
⛵	SAILBOAT = marina or yacht harbour
⛶	SQUARE FOUR CORNERS = intersection
⛷	SKIER = ski resort
⛸	ICE SKATE = ice skating rink
⛹	PERSON WITH BALL = track and field, gymnasium
⛺	TENT = camping site
⛻	JAPANESE BANK SYMBOL
⛼	HEADSTONE GRAVEYARD SYMBOL = graveyard, memorial park, cemetery
⛽	FUEL PUMP = petrol station, gas station
⛾	CUP ON BLACK SQUARE = drive-in restaurant
⛿	WHITE FLAG WITH HORIZONTAL MIDDLE BLACK STRIPE = Japanese self-defence force site
✁	UPPER BLADE SCISSORS
✂	BLACK SCISSORS
✃	LOWER BLADE SCISSORS
✄	WHITE SCISSORS
✅	WHITE HEAVY CHECK MARK - OK symbol (Accepted mark)
✆	TELEPHONE LOCATION SIGN
✇	TAPE DRIVE
✈	AIRPLANE
✉	ENVELOPE
✊	RAISED FIST = rock in Rock, Paper, Scissors game
✋	RAISED HAND = paper in Rock, Paper, Scissors game
✌	VICTORY HAND = scissors in Rock, Paper, Scissors game
✍	WRITING HAND
✎	LOWER RIGHT PENCIL
✏	PENCIL
✐	UPPER RIGHT PENCIL
✑	WHITE NIB
✒	BLACK NIB
✓	CHECK MARK
✔	HEAVY CHECK MARK
✕	MULTIPLICATION X
✖	HEAVY MULTIPLICATION X
✗	BALLOT X
✘	HEAVY BALLOT X
✙	OUTLINED GREEK CROSS
✚	HEAVY GREEK CROSS
✛	OPEN CENTRE CROSS
✜	HEAVY OPEN CENTRE CROSS
✝	LATIN CROSS
✞	SHADOWED WHITE LATIN CROSS
✟	OUTLINED LATIN CROSS
✠	MALTESE CROSS
✡	STAR OF DAVID
✢	FOUR TEARDROP-SPOKED ASTERISK
✣	FOUR BALLOON-SPOKED ASTERISK
✤	HEAVY FOUR BALLOON-SPOKED ASTERISK
✥	FOUR CLUB-SPOKED ASTERISK
✦	BLACK FOUR POINTED STAR
✧	WHITE FOUR POINTED STAR
✨	SPARKLES
✩	STRESS OUTLINED WHITE STAR
✪	CIRCLED WHITE STAR
✫	OPEN CENTRE BLACK STAR
✬	BLACK CENTRE WHITE STAR
✭	OUTLINED BLACK STAR
✮	HEAVY OUTLINED BLACK STAR
✯	PINWHEEL STAR
✰	SHADOWED WHITE STAR
✱	HEAVY ASTERISK
✲	OPEN CENTRE ASTERISK
✳	EIGHT SPOKED ASTERISK
✴	EIGHT POINTED BLACK STAR
✵	EIGHT POINTED PINWHEEL STAR
✶	SIX POINTED BLACK STAR = sextile
✷	EIGHT POINTED RECTILINEAR BLACK STAR
✸	HEAVY EIGHT POINTED RECTILINEAR BLACK STAR
✹	TWELVE POINTED BLACK STAR
✺	SIXTEEN POINTED ASTERISK = starburst
✻	TEARDROP-SPOKED ASTERISK
✼	OPEN CENTRE TEARDROP-SPOKED ASTERISK
✽	HEAVY TEARDROP-SPOKED ASTERISK
✾	SIX PETALLED BLACK AND WHITE FLORETTE
✿	BLACK FLORETTE
❀	WHITE FLORETTE
❁	EIGHT PETALLED OUTLINED BLACK FLORETTE
❂	CIRCLED OPEN CENTRE EIGHT POINTED STAR
❃	HEAVY TEARDROP-SPOKED PINWHEEL ASTERISK
❄	SNOWFLAKE
❅	TIGHT TRIFOLIATE SNOWFLAKE
❆	HEAVY CHEVRON SNOWFLAKE
❇	SPARKLE
❈	HEAVY SPARKLE
❉	BALLOON-SPOKED ASTERISK = jack
❊	EIGHT TEARDROP-SPOKED PROPELLER ASTERISK
❋	HEAVY EIGHT TEARDROP-SPOKED PROPELLER ASTERISK = turbofan
❌	CROSS MARK
❍	SHADOWED WHITE CIRCLE
❎	NEGATIVE SQUARED CROSS MARK
❏	LOWER RIGHT DROP-SHADOWED WHITE SQUARE
❐	UPPER RIGHT DROP-SHADOWED WHITE SQUARE
❑	LOWER RIGHT SHADOWED WHITE SQUARE
❒	UPPER RIGHT SHADOWED WHITE SQUARE
❓	BLACK QUESTION MARK ORNAMENT
❔	WHITE QUESTION MARK ORNAMENT
❕	WHITE EXCLAMATION MARK ORNAMENT
❖	BLACK DIAMOND MINUS WHITE X
❗	HEAVY EXCLAMATION MARK SYMBOL = obstacles on the road, ARIB STD B24
❘	LIGHT VERTICAL BAR
❙	MEDIUM VERTICAL BAR
❚	HEAVY VERTICAL BAR
❛	HEAVY SINGLE TURNED COMMA QUOTATION MARK ORNAMENT
❜	HEAVY SINGLE COMMA QUOTATION MARK ORNAMENT
❝	HEAVY DOUBLE TURNED COMMA QUOTATION MARK ORNAMENT
❞	HEAVY DOUBLE COMMA QUOTATION MARK ORNAMENT
❟	HEAVY LOW SINGLE COMMA QUOTATION MARK ORNAMENT
❠	HEAVY LOW DOUBLE COMMA QUOTATION MARK ORNAMENT
❡	CURVED STEM PARAGRAPH SIGN ORNAMENT
❢	HEAVY EXCLAMATION MARK ORNAMENT
❣	HEAVY HEART EXCLAMATION MARK ORNAMENT
❤	HEAVY BLACK HEART
❥	ROTATED HEAVY BLACK HEART BULLET
❦	FLORAL HEART = Aldus leaf
❧	ROTATED FLORAL HEART BULLET = hedera, ivy leaf
➔	HEAVY WIDE-HEADED RIGHTWARDS ARROW
➘	HEAVY SOUTH EAST ARROW
➚	HEAVY NORTH EAST ARROW
➛	DRAFTING POINT RIGHTWARDS ARROW
➜	HEAVY ROUND-TIPPED RIGHTWARDS ARROW
➝	TRIANGLE-HEADED RIGHTWARDS ARROW
➞	HEAVY TRIANGLE-HEADED RIGHTWARDS ARROW
➟	DASHED TRIANGLE-HEADED RIGHTWARDS ARROW
➠	HEAVY DASHED TRIANGLE-HEADED RIGHTWARDS ARROW
➡	BLACK RIGHTWARDS ARROW
➢	THREE-D TOP-LIGHTED RIGHTWARDS ARROWHEAD
➣	THREE-D BOTTOM-LIGHTED RIGHTWARDS ARROWHEAD
➥	HEAVY BLACK CURVED DOWNWARDS AND RIGHTWARDS ARROW
➦	HEAVY BLACK CURVED UPWARDS AND RIGHTWARDS ARROW
➧	SQUAT BLACK RIGHTWARDS ARROW
➨	HEAVY CONCAVE-POINTED BLACK RIGHTWARDS ARROW
➩	RIGHT-SHADED WHITE RIGHTWARDS ARROW
➪	LEFT-SHADED WHITE RIGHTWARDS ARROW
➫	BACK-TILTED SHADOWED WHITE RIGHTWARDS ARROW
➬	FRONT-TILTED SHADOWED WHITE RIGHTWARDS ARROW
➭	HEAVY LOWER RIGHT-SHADOWED WHITE RIGHTWARDS ARROW
➮	HEAVY UPPER RIGHT-SHADOWED WHITE RIGHTWARDS ARROW
➯	NOTCHED LOWER RIGHT-SHADOWED WHITE RIGHTWARDS ARROW
➱	NOTCHED UPPER RIGHT-SHADOWED WHITE RIGHTWARDS ARROW
➳	WHITE-FEATHERED RIGHTWARDS ARROW
➴	BLACK-FEATHERED SOUTH EAST ARROW
➵	BLACK-FEATHERED RIGHTWARDS ARROW
➶	BLACK-FEATHERED NORTH EAST ARROW
➷	HEAVY BLACK-FEATHERED SOUTH EAST ARROW
➸	HEAVY BLACK-FEATHERED RIGHTWARDS ARROW
➹	HEAVY BLACK-FEATHERED NORTH EAST ARROW
➺	TEARDROP-BARBED RIGHTWARDS ARROW
➻	HEAVY TEARDROP-SHANKED RIGHTWARDS ARROW
➼	WEDGE-TAILED RIGHTWARDS ARROW
➽	HEAVY WEDGE-TAILED RIGHTWARDS ARROW
➾	OPEN-OUTLINED RIGHTWARDS ARROW
⟰	UPWARDS QUADRUPLE ARROW
⟱	DOWNWARDS QUADRUPLE ARROW
⟲	ANTICLOCKWISE GAPPED CIRCLE ARROW
⟳	CLOCKWISE GAPPED CIRCLE ARROW
⟴	RIGHT ARROW WITH CIRCLED PLUS
⟵	LONG LEFTWARDS ARROW
⟷	LONG LEFT RIGHT ARROW
⟸	LONG LEFTWARDS DOUBLE ARROW
⟺	LONG LEFT RIGHT DOUBLE ARROW
⟻	LONG LEFTWARDS ARROW FROM BAR = maps from
⟼	LONG RIGHTWARDS ARROW FROM BAR = maps to
⟽	LONG LEFTWARDS DOUBLE ARROW FROM BAR
⟾	LONG RIGHTWARDS DOUBLE ARROW FROM BAR
⟿	LONG RIGHTWARDS SQUIGGLE ARROW
⤀	RIGHTWARDS TWO-HEADED ARROW WITH VERTICAL STROKE = z notation partial surjection
⤁	RIGHTWARDS TWO-HEADED ARROW WITH DOUBLE VERTICAL STROKE = z notation finite surjection
⤂	LEFTWARDS DOUBLE ARROW WITH VERTICAL STROKE
⤃	RIGHTWARDS DOUBLE ARROW WITH VERTICAL STROKE
⤄	LEFT RIGHT DOUBLE ARROW WITH VERTICAL STROKE
⤅	RIGHTWARDS TWO-HEADED ARROW FROM BAR = maps to
⤆	LEFTWARDS DOUBLE ARROW FROM BAR = maps from
⤇	RIGHTWARDS DOUBLE ARROW FROM BAR = maps to
⤈	DOWNWARDS ARROW WITH HORIZONTAL STROKE
⤉	UPWARDS ARROW WITH HORIZONTAL STROKE
⤊	UPWARDS TRIPLE ARROW
⤋	DOWNWARDS TRIPLE ARROW
⤌	LEFTWARDS DOUBLE DASH ARROW
⤍	RIGHTWARDS DOUBLE DASH ARROW
⤎	LEFTWARDS TRIPLE DASH ARROW
⤏	RIGHTWARDS TRIPLE DASH ARROW
⤐	RIGHTWARDS TWO-HEADED TRIPLE DASH ARROW
⤑	RIGHTWARDS ARROW WITH DOTTED STEM
⤒	UPWARDS ARROW TO BAR
⤓	DOWNWARDS ARROW TO BAR
⤔	RIGHTWARDS ARROW WITH TAIL WITH VERTICAL STROKE = z notation partial injection
⤕	RIGHTWARDS ARROW WITH TAIL WITH DOUBLE VERTICAL STROKE = z notation finite injection
⤖	RIGHTWARDS TWO-HEADED ARROW WITH TAIL = bijective mapping = z notation bijection
⤗	RIGHTWARDS TWO-HEADED ARROW WITH TAIL WITH VERTICAL STROKE = z notation surjective injection
⤘	RIGHTWARDS TWO-HEADED ARROW WITH TAIL WITH DOUBLE VERTICAL STROKE = z notation finite surjective injection
⤙	LEFTWARDS ARROW-TAIL
⤚	RIGHTWARDS ARROW-TAIL
⤛	LEFTWARDS DOUBLE ARROW-TAIL
⤜	RIGHTWARDS DOUBLE ARROW-TAIL
⤝	LEFTWARDS ARROW TO BLACK DIAMOND
⤞	RIGHTWARDS ARROW TO BLACK DIAMOND
⤟	LEFTWARDS ARROW FROM BAR TO BLACK DIAMOND
⤠	RIGHTWARDS ARROW FROM BAR TO BLACK DIAMOND
⤡	NORTH WEST AND SOUTH EAST ARROW
⤢	NORTH EAST AND SOUTH WEST ARROW
⤣	NORTH WEST ARROW WITH HOOK
⤤	NORTH EAST ARROW WITH HOOK
⤥	SOUTH EAST ARROW WITH HOOK
⤦	SOUTH WEST ARROW WITH HOOK
⤧	NORTH WEST ARROW AND NORTH EAST ARROW
⤨	NORTH EAST ARROW AND SOUTH EAST ARROW
⤩	SOUTH EAST ARROW AND SOUTH WEST ARROW
⤪	SOUTH WEST ARROW AND NORTH WEST ARROW
⤫	RISING DIAGONAL CROSSING FALLING DIAGONAL
⤬	FALLING DIAGONAL CROSSING RISING DIAGONAL
⤭	SOUTH EAST ARROW CROSSING NORTH EAST ARROW
⤮	NORTH EAST ARROW CROSSING SOUTH EAST ARROW
⤯	FALLING DIAGONAL CROSSING NORTH EAST ARROW
⤰	RISING DIAGONAL CROSSING SOUTH EAST ARROW
⤱	NORTH EAST ARROW CROSSING NORTH WEST ARROW
⤲	NORTH WEST ARROW CROSSING NORTH EAST ARROW
⤳	WAVE ARROW POINTING DIRECTLY RIGHT
⤴	ARROW POINTING RIGHTWARDS THEN CURVING UPWARDS
⤵	ARROW POINTING RIGHTWARDS THEN CURVING DOWNWARDS
⤶	ARROW POINTING DOWNWARDS THEN CURVING LEFTWARDS
⤸	RIGHT-SIDE ARC CLOCKWISE ARROW
⤹	LEFT-SIDE ARC ANTICLOCKWISE ARROW
⤺	TOP ARC ANTICLOCKWISE ARROW
⤻	BOTTOM ARC ANTICLOCKWISE ARROW
⤼	TOP ARC CLOCKWISE ARROW WITH MINUS
⤽	TOP ARC ANTICLOCKWISE ARROW WITH PLUS
⤾	LOWER RIGHT SEMICIRCULAR CLOCKWISE ARROW
⤿	LOWER LEFT SEMICIRCULAR ANTICLOCKWISE ARROW
⥀	ANTICLOCKWISE CLOSED CIRCLE ARROW
⥁	CLOCKWISE CLOSED CIRCLE ARROW
⥂	RIGHTWARDS ARROW ABOVE SHORT LEFTWARDS ARROW
⥃	LEFTWARDS ARROW ABOVE SHORT RIGHTWARDS ARROW
⥄	SHORT RIGHTWARDS ARROW ABOVE LEFTWARDS ARROW
⥅	RIGHTWARDS ARROW WITH PLUS BELOW
⥆	LEFTWARDS ARROW WITH PLUS BELOW
⥇	RIGHTWARDS ARROW THROUGH X
⥈	LEFT RIGHT ARROW THROUGH SMALL CIRCLE
⥉	UPWARDS TWO-HEADED ARROW FROM SMALL CIRCLE
⥊	LEFT BARB UP RIGHT BARB DOWN HARPOON
⥋	LEFT BARB DOWN RIGHT BARB UP HARPOON
⥌	UP BARB RIGHT DOWN BARB LEFT HARPOON
⥍	UP BARB LEFT DOWN BARB RIGHT HARPOON
⥎	LEFT BARB UP RIGHT BARB UP HARPOON
⥏	UP BARB RIGHT DOWN BARB RIGHT HARPOON
⥐	LEFT BARB DOWN RIGHT BARB DOWN HARPOON
⥑	UP BARB LEFT DOWN BARB LEFT HARPOON
⬀	NORTH EAST WHITE ARROW
⬁	NORTH WEST WHITE ARROW
⬂	SOUTH EAST WHITE ARROW
⬃	SOUTH WEST WHITE ARROW
⬄	LEFT RIGHT WHITE ARROW
⬅	LEFTWARDS BLACK ARROW
⬆	UPWARDS BLACK ARROW
⬇	DOWNWARDS BLACK ARROW
⬈	NORTH EAST BLACK ARROW
⬉	NORTH WEST BLACK ARROW
⬊	SOUTH EAST BLACK ARROW
⬋	SOUTH WEST BLACK ARROW
⬌	LEFT RIGHT BLACK ARROW
⬍	UP DOWN BLACK ARROW
⬎	RIGHTWARDS ARROW WITH TIP DOWNWARDS
⬏	RIGHTWARDS ARROW WITH TIP UPWARDS
⬐	LEFTWARDS ARROW WITH TIP DOWNWARDS
⬑	LEFTWARDS ARROW WITH TIP UPWARDS
⬒	SQUARE WITH TOP HALF BLACK
⬓	SQUARE WITH BOTTOM HALF BLACK
⬔	SQUARE WITH UPPER RIGHT DIAGONAL HALF BLACK
⬕	SQUARE WITH LOWER LEFT DIAGONAL HALF BLACK
⬖	DIAMOND WITH LEFT HALF BLACK
⬗	DIAMOND WITH RIGHT HALF BLACK
⬘	DIAMOND WITH TOP HALF BLACK
⬙	DIAMOND WITH BOTTOM HALF BLACK
⬚	DOTTED SQUARE
Ⱡ	LATIN CAPITAL LETTER L WITH DOUBLE BAR
ⱡ	LATIN SMALL LETTER L WITH DOUBLE BAR
Ᵽ	LATIN CAPITAL LETTER P WITH STROKE
ⱥ	LATIN SMALL LETTER A WITH STROKE
ⱦ	LATIN SMALL LETTER T WITH DIAGONAL STROKE
Ɑ	LATIN CAPITAL LETTER ALPHA
Ɐ	LATIN CAPITAL LETTER TURNED A
Ɒ	LATIN CAPITAL LETTER TURNED ALPHA
⸢	TOP LEFT HALF BRACKET
⸣	TOP RIGHT HALF BRACKET
⸤	BOTTOM LEFT HALF BRACKET
⸥	BOTTOM RIGHT HALF BRACKET
⸮	REVERSED QUESTION MARK = punctus percontativus
〃	DITTO MARK
〄	JAPANESE INDUSTRIAL STANDARD SYMBOL
ﬀ	LATIN SMALL LIGATURE FF
ﬁ	LATIN SMALL LIGATURE FI
ﬂ	LATIN SMALL LIGATURE FL
ﬃ	LATIN SMALL LIGATURE FFI
ﬄ	LATIN SMALL LIGATURE FFL
ﬅ	LATIN SMALL LIGATURE LONG S T
ﬆ	LATIN SMALL LIGATURE ST
﴿	ORNATE RIGHT PARENTHESIS
﷼	RIAL SIGN
︐	PRESENTATION FORM FOR VERTICAL COMMA
︑	PRESENTATION FORM FOR VERTICAL IDEOGRAPHIC COMMA
︒	PRESENTATION FORM FOR VERTICAL IDEOGRAPHIC FULL STOP
︓	PRESENTATION FORM FOR VERTICAL COLON
︔	PRESENTATION FORM FOR VERTICAL SEMICOLON
︕	PRESENTATION FORM FOR VERTICAL EXCLAMATION MARK
︖	PRESENTATION FORM FOR VERTICAL QUESTION MARK
︗	PRESENTATION FORM FOR VERTICAL LEFT WHITE LENTICULAR BRACKET
︘	PRESENTATION FORM FOR VERTICAL RIGHT WHITE LENTICULAR BRAKCET
︙	PRESENTATION FORM FOR VERTICAL HORIZONTAL ELLIPSIS
︰	PRESENTATION FORM FOR VERTICAL TWO DOT LEADER
︱	PRESENTATION FORM FOR VERTICAL EM DASH
︲	PRESENTATION FORM FOR VERTICAL EN DASH
︳	PRESENTATION FORM FOR VERTICAL LOW LINE
︴	PRESENTATION FORM FOR VERTICAL WAVY LOW LINE
︵	PRESENTATION FORM FOR VERTICAL LEFT PARENTHESIS
︶	PRESENTATION FORM FOR VERTICAL RIGHT PARENTHESIS
︷	PRESENTATION FORM FOR VERTICAL LEFT CURLY BRACKET
︸	PRESENTATION FORM FOR VERTICAL RIGHT CURLY BRACKET
︹	PRESENTATION FORM FOR VERTICAL LEFT TORTOISE SHELL BRACKET
︺	PRESENTATION FORM FOR VERTICAL RIGHT TORTOISE SHELL BRACKET
︻	PRESENTATION FORM FOR VERTICAL LEFT BLACK LENTICULAR BRACKET
︼	PRESENTATION FORM FOR VERTICAL RIGHT BLACK LENTICULAR BRACKET
︽	PRESENTATION FORM FOR VERTICAL LEFT DOUBLE ANGLE BRACKET
︾	PRESENTATION FORM FOR VERTICAL RIGHT DOUBLE ANGLE BRACKET
︿	PRESENTATION FORM FOR VERTICAL LEFT ANGLE BRACKET
﹀	PRESENTATION FORM FOR VERTICAL RIGHT ANGLE BRACKET
﹁	PRESENTATION FORM FOR VERTICAL LEFT CORNER BRACKET
﹂	PRESENTATION FORM FOR VERTICAL RIGHT CORNER BRACKET
﹃	PRESENTATION FORM FOR VERTICAL LEFT WHITE CORNER BRACKET
﹄	PRESENTATION FORM FOR VERTICAL RIGHT WHITE CORNER BRACKET
﹅	SESAME DOT
﹆	WHITE SESAME DOT
﹉	DASHED OVERLINE
﹊	CENTRELINE OVERLINE
﹋	WAVY OVERLINE
﹌	DOUBLE WAVY OVERLINE
﹍	DASHED LOW LINE
﹎	CENTRELINE LOW LINE
﹏	WAVY LOW LINE
﹐	SMALL COMMA
﹑	SMALL IDEOGRAPHIC COMMA
﹒	SMALL FULL STOP
﹔	SMALL SEMICOLON
﹕	SMALL COLON
﹖	SMALL QUESTION MARK
﹗	SMALL EXCLAMATION MARK
﹘	SMALL EM DASH
﹙	SMALL LEFT PARENTHESIS
﹚	SMALL RIGHT PARENTHESIS
﹛	SMALL LEFT CURLY BRACKET
﹜	SMALL RIGHT CURLY BRACKET
﹝	SMALL LEFT TORTOISE SHELL BRACKET
﹞	SMALL RIGHT TORTOISE SHELL BRACKET
﹟	SMALL NUMBER SIGN
﹠	SMALL AMPERSAND
﹡	SMALL ASTERISK
﹢	SMALL PLUS SIGN
﹣	SMALL HYPHEN-MINUS
﹤	SMALL LESS-THAN SIGN
﹥	SMALL GREATER-THAN SIGN
﹦	SMALL EQUALS SIGN
﹨	SMALL REVERSE SOLIDUS
﹩	SMALL DOLLAR SIGN
﹪	SMALL PERCENT SIGN
﹫	SMALL COMMERCIAL AT
﻿	ZERO WIDTH NO-BREAK SPACE = BYTE ORDER MARK (BOM), ZWNBSP
！	FULLWIDTH EXCLAMATION MARK
＂	FULLWIDTH QUOTATION MARK
＃	FULLWIDTH NUMBER SIGN
＄	FULLWIDTH DOLLAR SIGN
％	FULLWIDTH PERCENT SIGN
＆	FULLWIDTH AMPERSAND
＇	FULLWIDTH APOSTROPHE
（	FULLWIDTH LEFT PARENTHESIS
）	FULLWIDTH RIGHT PARENTHESIS
＊	FULLWIDTH ASTERISK
＋	FULLWIDTH PLUS SIGN
，	FULLWIDTH COMMA
－	FULLWIDTH HYPHEN-MINUS
．	FULLWIDTH FULL STOP
／	FULLWIDTH SOLIDUS
０	FULLWIDTH DIGIT ZERO
１	FULLWIDTH DIGIT ONE
２	FULLWIDTH DIGIT TWO
３	FULLWIDTH DIGIT THREE
４	FULLWIDTH DIGIT FOUR
５	FULLWIDTH DIGIT FIVE
６	FULLWIDTH DIGIT SIX
７	FULLWIDTH DIGIT SEVEN
８	FULLWIDTH DIGIT EIGHT
９	FULLWIDTH DIGIT NINE
：	FULLWIDTH COLON
；	FULLWIDTH SEMICOLON
＜	FULLWIDTH LESS-THAN SIGN
＝	FULLWIDTH EQUALS SIGN
＞	FULLWIDTH GREATER-THAN SIGN
？	FULLWIDTH QUESTION MARK
＠	FULLWIDTH COMMERCIAL AT
Ａ	FULLWIDTH LATIN CAPITAL LETTER A
Ｂ	FULLWIDTH LATIN CAPITAL LETTER B
Ｃ	FULLWIDTH LATIN CAPITAL LETTER C
Ｄ	FULLWIDTH LATIN CAPITAL LETTER D
Ｅ	FULLWIDTH LATIN CAPITAL LETTER E
Ｆ	FULLWIDTH LATIN CAPITAL LETTER F
Ｇ	FULLWIDTH LATIN CAPITAL LETTER G
Ｈ	FULLWIDTH LATIN CAPITAL LETTER H
Ｉ	FULLWIDTH LATIN CAPITAL LETTER I
Ｊ	FULLWIDTH LATIN CAPITAL LETTER J
Ｋ	FULLWIDTH LATIN CAPITAL LETTER K
Ｌ	FULLWIDTH LATIN CAPITAL LETTER L
Ｍ	FULLWIDTH LATIN CAPITAL LETTER M
Ｎ	FULLWIDTH LATIN CAPITAL LETTER N
Ｏ	FULLWIDTH LATIN CAPITAL LETTER O
Ｐ	FULLWIDTH LATIN CAPITAL LETTER P
Ｑ	FULLWIDTH LATIN CAPITAL LETTER Q
Ｒ	FULLWIDTH LATIN CAPITAL LETTER R
Ｓ	FULLWIDTH LATIN CAPITAL LETTER S
Ｔ	FULLWIDTH LATIN CAPITAL LETTER T
Ｕ	FULLWIDTH LATIN CAPITAL LETTER U
Ｖ	FULLWIDTH LATIN CAPITAL LETTER V
Ｗ	FULLWIDTH LATIN CAPITAL LETTER W
Ｘ	FULLWIDTH LATIN CAPITAL LETTER X
Ｙ	FULLWIDTH LATIN CAPITAL LETTER Y
Ｚ	FULLWIDTH LATIN CAPITAL LETTER Z
［	FULLWIDTH LEFT SQUARE BRACKET
＼	FULLWIDTH REVERSE SOLIDUS
］	FULLWIDTH RIGHT SQUARE BRACKET
＾	FULLWIDTH CIRCUMFLEX ACCENT
＿	FULLWIDTH LOW LINE
｀	FULLWIDTH GRAVE ACCENT
ａ	FULLWIDTH LATIN SMALL LETTER A
ｂ	FULLWIDTH LATIN SMALL LETTER B
ｃ	FULLWIDTH LATIN SMALL LETTER C
ｄ	FULLWIDTH LATIN SMALL LETTER D
ｅ	FULLWIDTH LATIN SMALL LETTER E
ｆ	FULLWIDTH LATIN SMALL LETTER F
ｇ	FULLWIDTH LATIN SMALL LETTER G
ｈ	FULLWIDTH LATIN SMALL LETTER H
ｉ	FULLWIDTH LATIN SMALL LETTER I
ｊ	FULLWIDTH LATIN SMALL LETTER J
ｋ	FULLWIDTH LATIN SMALL LETTER K
ｌ	FULLWIDTH LATIN SMALL LETTER L
ｍ	FULLWIDTH LATIN SMALL LETTER M
ｎ	FULLWIDTH LATIN SMALL LETTER N
ｏ	FULLWIDTH LATIN SMALL LETTER O
ｐ	FULLWIDTH LATIN SMALL LETTER P
ｑ	FULLWIDTH LATIN SMALL LETTER Q
ｒ	FULLWIDTH LATIN SMALL LETTER R
ｓ	FULLWIDTH LATIN SMALL LETTER S
ｔ	FULLWIDTH LATIN SMALL LETTER T
ｕ	FULLWIDTH LATIN SMALL LETTER U
ｖ	FULLWIDTH LATIN SMALL LETTER V
ｗ	FULLWIDTH LATIN SMALL LETTER W
ｘ	FULLWIDTH LATIN SMALL LETTER X
ｙ	FULLWIDTH LATIN SMALL LETTER Y
ｚ	FULLWIDTH LATIN SMALL LETTER Z
｛	FULLWIDTH LEFT CURLY BRACKET
｜	FULLWIDTH VERTICAL LINE
｝	FULLWIDTH RIGHT CURLY BRACKET
～	FULLWIDTH TILDE
｟	FULLWIDTH LEFT WHITE PARENTHESIS
｠	FULLWIDTH RIGHT WHITE PARENTHESIS
￠	FULLWIDTH CENT SIGN
￡	FULLWIDTH POUND SIGN
￢	FULLWIDTH NOT SIGN
￣	FULLWIDTH MACRON
￤	FULLWIDTH BROKEN BAR
￥	FULLWIDTH YEN SIGN
￦	FULLWIDTH WON SIGN
￼	OBJECT REPLACEMENT CHARACTER
�	REPLACEMENT CHARACTER
